AP,Portada,Categoría,Región,Periodo,Mes,Año,Acceso,ext,nacmay,rprov,rloc,est,jp,men,total,nactotal
Ciervo de los Pantanos,Única,PN,CENTRO,2017m1,1,2017,NO COBRA,29,88,344,147,0,8,141,757,728
El Leoncito,Única,PN,CENTRO,2017m1,1,2017,NO COBRA,191,1462,1776,342,0,0,0,3771,3580
El Palmar,Única,PN,CENTRO,2017m1,1,2017,COBRA,81,10133,4303,1219,701,1925,7766,26128,26047
Iberá,Cambyretá,PN,CENTRO,2017m1,1,2017,NO COBRA,41,884,0,0,0,0,0,925,884
Iberá,San Nicolás,PN,CENTRO,2017m1,1,2017,NO COBRA,0,0,0,0,0,0,0,0,0
Mburucuyá,Única,PN,CENTRO,2017m1,1,2017,NO COBRA,6,276,293,64,18,0,217,874,868
Pre Delta,Única,PN,CENTRO,2017m1,1,2017,NO COBRA,43,1345,1664,1603,38,86,1218,5997,5954
Quebrada del Condorito,Única,PN,CENTRO,2017m1,1,2017,NO COBRA,428,2066,784,109,0,0,0,3387,2959
San Guillermo,Única,PN,CENTRO,2017m1,1,2017,NO COBRA,0,0,0,0,0,0,0,0,0
Sierra de las Quijadas,Única,PN,CENTRO,2017m1,1,2017,COBRA,137,2156,129,0,189,204,859,3674,3537
Talampaya,Única,PN,CENTRO,2017m1,1,2017,COBRA,762,4034,117,0,225,536,1265,6939,6177
Chaco,Única,PN,NEA,2017m1,1,2017,NO COBRA,38,187,202,162,0,6,339,934,896
Colonia Benítez,Única,RNEd,NEA,2017m1,1,2017,NO COBRA,0,0,0,0,0,0,0,0,0
El Impenetrable,Única,PN,NEA,2017m1,1,2017,NO COBRA,0,0,0,0,0,0,0,0,0
Formosa,Única,RNat,NEA,2017m1,1,2017,NO COBRA,0,0,0,0,0,0,0,0,0
Iguazú,Única,PN,NEA,2017m1,1,2017,COBRA,109550,152032,12108,6218,0,24283,30445,334636,225086
Río Pilcomayo,Estero Poi,PN,NEA,2017m1,1,2017,NO COBRA,12,18,17,4,0,0,21,72,60
Río Pilcomayo,Laguna Blanca,PN,NEA,2017m1,1,2017,NO COBRA,41,224,409,2434,0,0,1268,4376,4335
Aconquija,Única,PN,NOA,2017m1,1,2017,NO COBRA,2,10,0,17,0,0,25,54,52
Baritú,Única,PN,NOA,2017m1,1,2017,NO COBRA,0,0,2,0,0,0,0,2,2
Calilegua,Única,PN,NOA,2017m1,1,2017,NO COBRA,54,1295,241,422,0,0,237,2249,2195
Copo,Guayacán,PN,NOA,2017m1,1,2017,NO COBRA,0,0,0,0,0,0,0,0,0
Copo,Portada,PN,NOA,2017m1,1,2017,NO COBRA,0,9,0,0,0,0,0,9,9
El Rey,Única,PN,NOA,2017m1,1,2017,NO COBRA,4,0,22,0,0,0,11,37,33
Laguna de los Pozuelos,Única,MN,NOA,2017m1,1,2017,NO COBRA,52,77,30,30,2,0,29,220,168
Los Cardones,Recta del Tín Tín,PN,NOA,2017m1,1,2017,NO COBRA,603,5893,485,24,0,3910,31,10946,10343
Los Cardones,Valle Encantado,PN,NOA,2017m1,1,2017,NO COBRA,0,0,0,0,0,0,0,0,0
Nogalar de los Toldos,Única,RNac,NOA,2017m1,1,2017,NO COBRA,25,5,4,156,80,1,24,295,270
Pizarro,Única,RNac,NOA,2017m1,1,2017,NO COBRA,0,0,0,0,0,0,0,0,0
Bosques Petrificados,Única,PN,PATAGONIA,2017m1,1,2017,NO COBRA,276,1438,106,48,90,39,398,2395,2119
Lago Puelo,Única,PN,PATAGONIA,2017m1,1,2017,COBRA,1682,51798,15797,35570,5311,10972,19020,140150,138468
Laguna Blanca,Única,PN,PATAGONIA,2017m1,1,2017,NO COBRA,25,310,144,50,0,0,103,632,607
Lanín,Hua Hum,PN,PATAGONIA,2017m1,1,2017,NO COBRA,0,0,0,0,0,0,0,0,0
Lanín,Lago Huechulaufquen,PN,PATAGONIA,2017m1,1,2017,COBRA,625,18182,2834,0,2693,12777,0,37111,36486
Lanín,Muelle Lago Lácar,PN,PATAGONIA,2017m1,1,2017,COBRA,490,4253,1878,0,1238,1478,0,9337,8847
Lanín,Quila Quina,PN,PATAGONIA,2017m1,1,2017,COBRA,1161,10503,2710,0,1577,3981,0,19932,18771
Lanín,Ruka Choroy,PN,PATAGONIA,2017m1,1,2017,NO COBRA,0,0,0,0,0,0,0,0,0
Lanín,Volcán Lanín,PN,PATAGONIA,2017m1,1,2017,NO COBRA,0,0,0,0,0,0,0,0,0
Lanín,Área Tromen,PN,PATAGONIA,2017m1,1,2017,NO COBRA,0,0,0,0,0,0,0,0,0
Lanín,Ñorkinko,PN,PATAGONIA,2017m1,1,2017,NO COBRA,0,0,0,0,0,0,0,0,0
Lihué Calel,Única,PN,PATAGONIA,2017m1,1,2017,NO COBRA,39,386,50,2,0,0,162,639,600
Los Alerces,Portada Centro,PN,PATAGONIA,2017m1,1,2017,COBRA,0,0,0,0,0,0,0,0,0
Los Alerces,Portada Norte,PN,PATAGONIA,2017m1,1,2017,COBRA,0,0,0,0,0,0,0,0,0
Los Alerces,Portada Sur,PN,PATAGONIA,2017m1,1,2017,COBRA,0,0,0,0,0,0,0,0,0
Los Alerces,Villa Futalaufquen,PN,PATAGONIA,2017m1,1,2017,NO COBRA,2240,19520,10409,26736,3292,3242,14452,79891,77651
Los Glaciares,El Chaltén,PN,PATAGONIA,2017m1,1,2017,NO COBRA,10952,10087,0,0,0,0,0,21039,10087
Los Glaciares,Puerto Bandera,PN,PATAGONIA,2017m1,1,2017,COBRA,7791,8562,77,4079,1200,0,861,22570,14779
Los Glaciares,Puerto La Cruz,PN,PATAGONIA,2017m1,1,2017,NO COBRA,0,0,0,0,0,0,0,0,0
Los Glaciares,Puerto La Soledad,PN,PATAGONIA,2017m1,1,2017,COBRA,5393,877,0,251,0,0,368,6889,1496
Los Glaciares,Puerto Lago Argentino,PN,PATAGONIA,2017m1,1,2017,COBRA,0,0,0,0,0,0,0,0,0
Los Glaciares,Río Mitre,PN,PATAGONIA,2017m1,1,2017,COBRA,61070,31377,7408,9639,5308,7273,15425,137500,76430
Monte León,Única,PN,PATAGONIA,2017m1,1,2017,NO COBRA,504,1216,465,552,28,0,855,3620,3116
Nahuel Huapi,Lago Mascardi,PN,PATAGONIA,2017m1,1,2017,COBRA,2347,18404,2079,12311,2647,0,0,37788,35441
Nahuel Huapi,Puerto Pañuelo,PN,PATAGONIA,2017m1,1,2017,COBRA,3618,21406,1828,17150,7699,0,0,51701,48083
Nahuel Huapi,Quetrihué,PN,PATAGONIA,2017m1,1,2017,COBRA,1201,4741,3471,6115,3121,0,0,18649,17448
Nahuel Huapi,Río Limay,PN,PATAGONIA,2017m1,1,2017,COBRA,0,0,0,0,4885,0,0,4885,4885
Patagonia,Única,PN,PATAGONIA,2017m1,1,2017,NO COBRA,0,0,0,0,0,0,0,0,0
Perito Moreno,Única,PN,PATAGONIA,2017m1,1,2017,NO COBRA,105,200,14,4,0,0,73,396,291
Tierra del Fuego,Ruta Nacional 3,PN,PATAGONIA,2017m1,1,2017,COBRA,26304,9705,13682,0,1877,4519,5077,61164,34860
Tierra del Fuego,Tren del Fin del Mundo,PN,PATAGONIA,2017m1,1,2017,COBRA,9824,8028,582,0,553,2662,1890,23539,13715
Ciervo de los Pantanos,Única,PN,CENTRO,2017m2,2,2017,NO COBRA,9,126,316,71,0,9,144,675,666
El Leoncito,Única,PN,CENTRO,2017m2,2,2017,NO COBRA,133,1349,1819,297,0,0,0,3598,3465
El Palmar,Única,PN,CENTRO,2017m2,2,2017,COBRA,123,13544,3523,400,477,1565,6986,26618,26495
Iberá,Cambyretá,PN,CENTRO,2017m2,2,2017,NO COBRA,26,617,0,0,0,0,0,643,617
Iberá,San Nicolás,PN,CENTRO,2017m2,2,2017,NO COBRA,0,0,0,0,0,0,0,0,0
Mburucuyá,Única,PN,CENTRO,2017m2,2,2017,NO COBRA,35,421,165,87,9,4,197,918,883
Pre Delta,Única,PN,CENTRO,2017m2,2,2017,NO COBRA,33,1854,2054,2454,41,89,1748,8273,8240
Quebrada del Condorito,Única,PN,CENTRO,2017m2,2,2017,NO COBRA,320,2337,1571,124,0,0,0,4352,4032
San Guillermo,Única,PN,CENTRO,2017m2,2,2017,NO COBRA,0,0,0,0,0,0,0,0,0
Sierra de las Quijadas,Única,PN,CENTRO,2017m2,2,2017,COBRA,98,1497,160,0,31,218,547,2551,2453
Talampaya,Única,PN,CENTRO,2017m2,2,2017,COBRA,566,1898,94,0,209,400,577,3744,3178
Chaco,Única,PN,NEA,2017m2,2,2017,NO COBRA,4,84,283,100,55,0,131,657,653
Colonia Benítez,Única,RNEd,NEA,2017m2,2,2017,NO COBRA,0,0,0,0,0,0,0,0,0
El Impenetrable,Única,PN,NEA,2017m2,2,2017,NO COBRA,0,0,0,0,0,0,0,0,0
Formosa,Única,RNat,NEA,2017m2,2,2017,NO COBRA,0,0,0,0,0,0,0,0,0
Iguazú,Única,PN,NEA,2017m2,2,2017,COBRA,95660,77776,9979,3466,0,20537,21361,228779,133119
Río Pilcomayo,Estero Poi,PN,NEA,2017m2,2,2017,NO COBRA,0,38,81,35,0,0,22,176,176
Río Pilcomayo,Laguna Blanca,PN,NEA,2017m2,2,2017,NO COBRA,16,60,253,476,0,0,150,955,939
Aconquija,Única,PN,NOA,2017m2,2,2017,NO COBRA,2,4,0,8,0,0,0,14,12
Baritú,Única,PN,NOA,2017m2,2,2017,NO COBRA,0,0,2,0,0,0,0,2,2
Calilegua,Única,PN,NOA,2017m2,2,2017,NO COBRA,100,576,189,276,0,0,300,1441,1341
Copo,Guayacán,PN,NOA,2017m2,2,2017,NO COBRA,0,0,0,0,0,0,0,0,0
Copo,Portada,PN,NOA,2017m2,2,2017,NO COBRA,0,8,0,0,0,0,0,8,8
El Rey,Única,PN,NOA,2017m2,2,2017,NO COBRA,0,0,4,0,0,0,0,4,4
Laguna de los Pozuelos,Única,MN,NOA,2017m2,2,2017,NO COBRA,31,73,52,16,0,0,23,195,164
Los Cardones,Recta del Tín Tín,PN,NOA,2017m2,2,2017,NO COBRA,485,3611,468,85,0,4949,59,9657,9172
Los Cardones,Valle Encantado,PN,NOA,2017m2,2,2017,NO COBRA,0,0,0,0,0,0,0,0,0
Nogalar de los Toldos,Única,RNac,NOA,2017m2,2,2017,NO COBRA,0,6,4,20,0,0,0,30,30
Pizarro,Única,RNac,NOA,2017m2,2,2017,NO COBRA,0,0,0,0,0,0,0,0,0
Bosques Petrificados,Única,PN,PATAGONIA,2017m2,2,2017,NO COBRA,145,455,144,16,20,15,155,950,805
Lago Puelo,Única,PN,PATAGONIA,2017m2,2,2017,COBRA,1596,35672,21011,22637,4225,4267,14048,103456,101860
Laguna Blanca,Única,PN,PATAGONIA,2017m2,2,2017,NO COBRA,35,64,74,109,0,0,75,357,322
Lanín,Hua Hum,PN,PATAGONIA,2017m2,2,2017,NO COBRA,0,0,0,0,0,0,0,0,0
Lanín,Lago Huechulaufquen,PN,PATAGONIA,2017m2,2,2017,COBRA,470,6203,1476,0,375,5778,0,14302,13832
Lanín,Muelle Lago Lácar,PN,PATAGONIA,2017m2,2,2017,COBRA,630,3972,1040,0,271,1060,0,6973,6343
Lanín,Quila Quina,PN,PATAGONIA,2017m2,2,2017,COBRA,573,6217,1868,0,400,1726,0,10784,10211
Lanín,Ruka Choroy,PN,PATAGONIA,2017m2,2,2017,NO COBRA,0,0,0,0,0,0,0,0,0
Lanín,Volcán Lanín,PN,PATAGONIA,2017m2,2,2017,NO COBRA,0,0,0,0,0,0,0,0,0
Lanín,Área Tromen,PN,PATAGONIA,2017m2,2,2017,NO COBRA,0,0,0,0,0,0,0,0,0
Lanín,Ñorkinko,PN,PATAGONIA,2017m2,2,2017,NO COBRA,0,0,0,0,0,0,0,0,0
Lihué Calel,Única,PN,PATAGONIA,2017m2,2,2017,NO COBRA,16,242,38,50,0,1,110,457,441
Los Alerces,Portada Centro,PN,PATAGONIA,2017m2,2,2017,COBRA,0,0,0,0,0,0,0,0,0
Los Alerces,Portada Norte,PN,PATAGONIA,2017m2,2,2017,COBRA,0,0,0,0,0,0,0,0,0
Los Alerces,Portada Sur,PN,PATAGONIA,2017m2,2,2017,COBRA,0,0,0,0,0,0,0,0,0
Los Alerces,Villa Futalaufquen,PN,PATAGONIA,2017m2,2,2017,NO COBRA,2228,11029,5115,20539,773,3276,21206,64166,61938
Los Glaciares,El Chaltén,PN,PATAGONIA,2017m2,2,2017,NO COBRA,14296,6908,0,0,0,0,0,21204,6908
Los Glaciares,Puerto Bandera,PN,PATAGONIA,2017m2,2,2017,COBRA,12637,4854,114,4530,711,0,379,23225,10588
Los Glaciares,Puerto La Cruz,PN,PATAGONIA,2017m2,2,2017,NO COBRA,0,0,0,0,0,0,0,0,0
Los Glaciares,Puerto La Soledad,PN,PATAGONIA,2017m2,2,2017,COBRA,967,121,0,201,55,0,0,1344,377
Los Glaciares,Puerto Lago Argentino,PN,PATAGONIA,2017m2,2,2017,COBRA,0,0,0,0,0,0,0,0,0
Los Glaciares,Río Mitre,PN,PATAGONIA,2017m2,2,2017,COBRA,61804,27643,9249,10636,2076,5645,11684,128737,66933
Monte León,Única,PN,PATAGONIA,2017m2,2,2017,NO COBRA,264,648,288,495,0,0,883,2578,2314
Nahuel Huapi,Lago Mascardi,PN,PATAGONIA,2017m2,2,2017,COBRA,2451,11853,656,7228,694,0,0,22882,20431
Nahuel Huapi,Puerto Pañuelo,PN,PATAGONIA,2017m2,2,2017,COBRA,3753,12392,593,12263,501,0,0,29502,25749
Nahuel Huapi,Quetrihué,PN,PATAGONIA,2017m2,2,2017,COBRA,1164,5386,1952,3620,1281,0,0,13403,12239
Nahuel Huapi,Río Limay,PN,PATAGONIA,2017m2,2,2017,COBRA,0,0,0,0,0,0,0,0,0
Patagonia,Única,PN,PATAGONIA,2017m2,2,2017,NO COBRA,0,0,0,0,0,0,0,0,0
Perito Moreno,Única,PN,PATAGONIA,2017m2,2,2017,NO COBRA,142,142,8,0,0,0,31,323,181
Tierra del Fuego,Ruta Nacional 3,PN,PATAGONIA,2017m2,2,2017,COBRA,19037,7048,12438,0,830,3156,4762,47271,28234
Tierra del Fuego,Tren del Fin del Mundo,PN,PATAGONIA,2017m2,2,2017,COBRA,12142,4615,414,0,179,3234,2348,22932,10790
Ciervo de los Pantanos,Única,PN,CENTRO,2017m3,3,2017,NO COBRA,90,252,475,173,42,16,293,1341,1251
El Leoncito,Única,PN,CENTRO,2017m3,3,2017,NO COBRA,301,626,1141,155,0,0,0,2223,1922
El Palmar,Única,PN,CENTRO,2017m3,3,2017,COBRA,95,6808,1743,881,261,1038,1580,12406,12311
Iberá,Cambyretá,PN,CENTRO,2017m3,3,2017,NO COBRA,77,173,0,0,0,0,0,250,173
Iberá,San Nicolás,PN,CENTRO,2017m3,3,2017,NO COBRA,0,0,0,0,0,0,0,0,0
Mburucuyá,Única,PN,CENTRO,2017m3,3,2017,NO COBRA,9,144,60,103,0,0,49,365,356
Pre Delta,Única,PN,CENTRO,2017m3,3,2017,NO COBRA,50,1129,2938,2874,228,122,1792,9133,9083
Quebrada del Condorito,Única,PN,CENTRO,2017m3,3,2017,NO COBRA,397,1106,3079,269,0,0,0,4851,4454
San Guillermo,Única,PN,CENTRO,2017m3,3,2017,NO COBRA,0,0,0,0,0,0,0,0,0
Sierra de las Quijadas,Única,PN,CENTRO,2017m3,3,2017,COBRA,105,1091,134,28,119,438,156,2071,1966
Talampaya,Única,PN,CENTRO,2017m3,3,2017,COBRA,1003,2754,53,0,87,1138,129,5164,4161
Chaco,Única,PN,NEA,2017m3,3,2017,NO COBRA,13,60,176,65,0,0,130,444,431
Colonia Benítez,Única,RNEd,NEA,2017m3,3,2017,NO COBRA,0,0,0,0,0,0,0,0,0
El Impenetrable,Única,PN,NEA,2017m3,3,2017,NO COBRA,0,0,0,0,0,0,0,0,0
Formosa,Única,RNat,NEA,2017m3,3,2017,NO COBRA,0,0,0,0,0,0,0,0,0
Iguazú,Única,PN,NEA,2017m3,3,2017,COBRA,53196,46090,3509,1435,0,11624,10831,126685,73489
Río Pilcomayo,Estero Poi,PN,NEA,2017m3,3,2017,NO COBRA,15,52,138,174,0,0,81,460,445
Río Pilcomayo,Laguna Blanca,PN,NEA,2017m3,3,2017,NO COBRA,2,28,36,15,0,0,9,90,88
Aconquija,Única,PN,NOA,2017m3,3,2017,NO COBRA,0,0,0,15,0,0,0,15,15
Baritú,Única,PN,NOA,2017m3,3,2017,NO COBRA,0,11,0,0,0,0,0,11,11
Calilegua,Única,PN,NOA,2017m3,3,2017,NO COBRA,104,359,39,230,0,0,114,846,742
Copo,Guayacán,PN,NOA,2017m3,3,2017,NO COBRA,0,0,0,0,0,0,0,0,0
Copo,Portada,PN,NOA,2017m3,3,2017,NO COBRA,0,10,0,0,0,0,0,10,10
El Rey,Única,PN,NOA,2017m3,3,2017,NO COBRA,9,0,0,0,0,0,0,9,0
Laguna de los Pozuelos,Única,MN,NOA,2017m3,3,2017,NO COBRA,51,49,9,0,0,0,8,117,66
Los Cardones,Recta del Tín Tín,PN,NOA,2017m3,3,2017,NO COBRA,721,8009,437,79,0,6093,71,15410,14689
Los Cardones,Valle Encantado,PN,NOA,2017m3,3,2017,NO COBRA,0,0,0,0,0,0,0,0,0
Nogalar de los Toldos,Única,RNac,NOA,2017m3,3,2017,NO COBRA,2,2,2,0,0,0,0,6,4
Pizarro,Única,RNac,NOA,2017m3,3,2017,NO COBRA,0,0,0,0,0,0,0,0,0
Bosques Petrificados,Única,PN,PATAGONIA,2017m3,3,2017,NO COBRA,181,158,117,16,17,74,25,588,407
Lago Puelo,Única,PN,PATAGONIA,2017m3,3,2017,COBRA,390,10616,2296,9164,992,9203,92,32753,32363
Laguna Blanca,Única,PN,PATAGONIA,2017m3,3,2017,NO COBRA,19,94,46,70,0,58,45,332,313
Lanín,Hua Hum,PN,PATAGONIA,2017m3,3,2017,NO COBRA,0,0,0,0,0,0,0,0,0
Lanín,Lago Huechulaufquen,PN,PATAGONIA,2017m3,3,2017,COBRA,138,4043,837,0,770,1770,0,7558,7420
Lanín,Muelle Lago Lácar,PN,PATAGONIA,2017m3,3,2017,COBRA,183,2191,441,0,432,707,31,3985,3802
Lanín,Quila Quina,PN,PATAGONIA,2017m3,3,2017,COBRA,154,2206,1251,0,451,477,16,4555,4401
Lanín,Ruka Choroy,PN,PATAGONIA,2017m3,3,2017,NO COBRA,0,0,0,0,0,0,0,0,0
Lanín,Volcán Lanín,PN,PATAGONIA,2017m3,3,2017,NO COBRA,0,0,0,0,0,0,0,0,0
Lanín,Área Tromen,PN,PATAGONIA,2017m3,3,2017,NO COBRA,0,0,0,0,0,0,0,0,0
Lanín,Ñorkinko,PN,PATAGONIA,2017m3,3,2017,NO COBRA,0,0,0,0,0,0,0,0,0
Lihué Calel,Única,PN,PATAGONIA,2017m3,3,2017,NO COBRA,39,131,79,32,0,1,37,319,280
Los Alerces,Portada Centro,PN,PATAGONIA,2017m3,3,2017,COBRA,355,2064,870,5499,100,1094,556,10538,10183
Los Alerces,Portada Norte,PN,PATAGONIA,2017m3,3,2017,COBRA,186,1168,463,619,60,420,309,3225,3039
Los Alerces,Portada Sur,PN,PATAGONIA,2017m3,3,2017,COBRA,91,861,728,3406,67,808,1167,7128,7037
Los Alerces,Villa Futalaufquen,PN,PATAGONIA,2017m3,3,2017,NO COBRA,0,0,0,0,0,0,0,0,0
Los Glaciares,El Chaltén,PN,PATAGONIA,2017m3,3,2017,NO COBRA,6647,7162,0,0,0,0,0,13809,7162
Los Glaciares,Puerto Bandera,PN,PATAGONIA,2017m3,3,2017,COBRA,6276,6594,42,3444,795,0,204,17355,11079
Los Glaciares,Puerto La Cruz,PN,PATAGONIA,2017m3,3,2017,NO COBRA,0,0,0,0,0,0,0,0,0
Los Glaciares,Puerto La Soledad,PN,PATAGONIA,2017m3,3,2017,COBRA,3121,1508,19,293,110,0,0,5051,1930
Los Glaciares,Puerto Lago Argentino,PN,PATAGONIA,2017m3,3,2017,COBRA,0,0,0,0,0,0,0,0,0
Los Glaciares,Río Mitre,PN,PATAGONIA,2017m3,3,2017,COBRA,38268,10881,1954,2847,2167,11661,1404,69182,30914
Monte León,Única,PN,PATAGONIA,2017m3,3,2017,NO COBRA,145,81,122,19,0,0,51,418,273
Nahuel Huapi,Lago Mascardi,PN,PATAGONIA,2017m3,3,2017,COBRA,2004,8336,331,4581,720,0,243,16215,14211
Nahuel Huapi,Puerto Pañuelo,PN,PATAGONIA,2017m3,3,2017,COBRA,3099,11201,241,7319,1388,0,436,23684,20585
Nahuel Huapi,Quetrihué,PN,PATAGONIA,2017m3,3,2017,COBRA,430,3516,1073,1651,763,0,135,7568,7138
Nahuel Huapi,Río Limay,PN,PATAGONIA,2017m3,3,2017,COBRA,0,0,0,0,0,0,0,0,0
Patagonia,Única,PN,PATAGONIA,2017m3,3,2017,NO COBRA,0,0,0,0,0,0,0,0,0
Perito Moreno,Única,PN,PATAGONIA,2017m3,3,2017,NO COBRA,54,26,16,2,0,0,7,105,51
Tierra del Fuego,Ruta Nacional 3,PN,PATAGONIA,2017m3,3,2017,COBRA,10921,5998,6350,0,918,2709,1324,28220,17299
Tierra del Fuego,Tren del Fin del Mundo,PN,PATAGONIA,2017m3,3,2017,COBRA,7586,3263,380,0,213,2983,460,14885,7299
Ciervo de los Pantanos,Única,PN,CENTRO,2017m4,4,2017,NO COBRA,15,195,710,174,0,10,434,1538,1523
El Leoncito,Única,PN,CENTRO,2017m4,4,2017,NO COBRA,133,910,1928,379,0,0,0,3350,3217
El Palmar,Única,PN,CENTRO,2017m4,4,2017,COBRA,85,8667,2658,890,17,1814,3469,17600,17515
Iberá,Cambyretá,PN,CENTRO,2017m4,4,2017,NO COBRA,7,19,0,0,0,0,0,26,19
Iberá,San Nicolás,PN,CENTRO,2017m4,4,2017,NO COBRA,0,0,0,0,0,0,0,0,0
Mburucuyá,Única,PN,CENTRO,2017m4,4,2017,NO COBRA,10,48,88,87,0,0,105,338,328
Pre Delta,Única,PN,CENTRO,2017m4,4,2017,NO COBRA,78,2824,4130,5676,39,296,1990,15033,14955
Quebrada del Condorito,Única,PN,CENTRO,2017m4,4,2017,NO COBRA,484,792,2007,86,0,0,0,3369,2885
San Guillermo,Única,PN,CENTRO,2017m4,4,2017,NO COBRA,2,6,0,0,0,0,6,14,12
Sierra de las Quijadas,Única,PN,CENTRO,2017m4,4,2017,COBRA,87,1605,313,10,185,585,135,2920,2833
Talampaya,Única,PN,CENTRO,2017m4,4,2017,COBRA,596,5572,185,0,376,2677,717,10123,9527
Chaco,Única,PN,NEA,2017m4,4,2017,NO COBRA,16,38,95,48,0,0,76,273,257
Colonia Benítez,Única,RNEd,NEA,2017m4,4,2017,NO COBRA,0,0,0,0,0,0,0,0,0
El Impenetrable,Única,PN,NEA,2017m4,4,2017,NO COBRA,0,0,0,0,0,0,0,0,0
Formosa,Única,RNat,NEA,2017m4,4,2017,NO COBRA,0,3,0,0,0,0,0,3,3
Iguazú,Única,PN,NEA,2017m4,4,2017,COBRA,66014,55834,3106,1128,0,17471,17404,160957,94943
Río Pilcomayo,Estero Poi,PN,NEA,2017m4,4,2017,NO COBRA,13,60,23,46,2,0,5,149,136
Río Pilcomayo,Laguna Blanca,PN,NEA,2017m4,4,2017,NO COBRA,30,73,409,363,0,0,201,1076,1046
Aconquija,Única,PN,NOA,2017m4,4,2017,NO COBRA,0,0,0,7,0,0,2,9,9
Baritú,Única,PN,NOA,2017m4,4,2017,NO COBRA,2,3,0,0,0,0,0,5,3
Calilegua,Única,PN,NOA,2017m4,4,2017,NO COBRA,184,255,52,166,0,0,109,766,582
Copo,Guayacán,PN,NOA,2017m4,4,2017,NO COBRA,0,0,0,0,0,0,0,0,0
Copo,Portada,PN,NOA,2017m4,4,2017,NO COBRA,0,10,0,0,0,0,0,10,10
El Rey,Única,PN,NOA,2017m4,4,2017,NO COBRA,0,2,9,2,0,0,9,22,22
Laguna de los Pozuelos,Única,MN,NOA,2017m4,4,2017,NO COBRA,45,55,27,9,12,0,22,170,125
Los Cardones,Recta del Tín Tín,PN,NOA,2017m4,4,2017,NO COBRA,453,6680,486,59,0,3081,57,10816,10363
Los Cardones,Valle Encantado,PN,NOA,2017m4,4,2017,NO COBRA,0,0,0,0,0,0,0,0,0
Nogalar de los Toldos,Única,RNac,NOA,2017m4,4,2017,NO COBRA,22,0,21,0,0,0,0,43,21
Pizarro,Única,RNac,NOA,2017m4,4,2017,NO COBRA,0,0,0,0,0,0,0,0,0
Bosques Petrificados,Única,PN,PATAGONIA,2017m4,4,2017,NO COBRA,34,23,65,16,10,4,35,187,153
Lago Puelo,Única,PN,PATAGONIA,2017m4,4,2017,COBRA,142,4083,1633,3499,325,459,447,10588,10446
Laguna Blanca,Única,PN,PATAGONIA,2017m4,4,2017,NO COBRA,11,22,597,52,12,97,75,866,855
Lanín,Hua Hum,PN,PATAGONIA,2017m4,4,2017,NO COBRA,0,0,0,0,0,0,0,0,0
Lanín,Lago Huechulaufquen,PN,PATAGONIA,2017m4,4,2017,COBRA,153,1719,457,0,116,0,0,2445,2292
Lanín,Muelle Lago Lácar,PN,PATAGONIA,2017m4,4,2017,COBRA,48,859,259,0,151,389,125,1831,1783
Lanín,Quila Quina,PN,PATAGONIA,2017m4,4,2017,COBRA,20,1201,257,0,83,312,12,1885,1865
Lanín,Ruka Choroy,PN,PATAGONIA,2017m4,4,2017,NO COBRA,0,0,0,0,0,0,0,0,0
Lanín,Volcán Lanín,PN,PATAGONIA,2017m4,4,2017,NO COBRA,0,0,0,0,0,0,0,0,0
Lanín,Área Tromen,PN,PATAGONIA,2017m4,4,2017,NO COBRA,0,0,0,0,0,0,0,0,0
Lanín,Ñorkinko,PN,PATAGONIA,2017m4,4,2017,NO COBRA,0,0,0,0,0,0,0,0,0
Lihué Calel,Única,PN,PATAGONIA,2017m4,4,2017,NO COBRA,9,153,103,44,0,0,96,405,396
Los Alerces,Portada Centro,PN,PATAGONIA,2017m4,4,2017,COBRA,237,460,1278,2869,12,293,338,5487,5250
Los Alerces,Portada Norte,PN,PATAGONIA,2017m4,4,2017,COBRA,46,301,345,270,6,170,206,1344,1298
Los Alerces,Portada Sur,PN,PATAGONIA,2017m4,4,2017,COBRA,26,370,421,3223,44,323,823,5230,5204
Los Alerces,Villa Futalaufquen,PN,PATAGONIA,2017m4,4,2017,NO COBRA,0,0,0,0,0,0,0,0,0
Los Glaciares,El Chaltén,PN,PATAGONIA,2017m4,4,2017,NO COBRA,5994,4041,0,0,0,0,0,10035,4041
Los Glaciares,Puerto Bandera,PN,PATAGONIA,2017m4,4,2017,COBRA,4732,5403,43,3030,359,0,319,13886,9154
Los Glaciares,Puerto La Cruz,PN,PATAGONIA,2017m4,4,2017,NO COBRA,0,0,0,0,0,0,0,0,0
Los Glaciares,Puerto La Soledad,PN,PATAGONIA,2017m4,4,2017,COBRA,787,624,0,264,108,0,122,1905,1118
Los Glaciares,Puerto Lago Argentino,PN,PATAGONIA,2017m4,4,2017,COBRA,0,0,0,0,0,0,0,0,0
Los Glaciares,Río Mitre,PN,PATAGONIA,2017m4,4,2017,COBRA,24480,10164,2376,2383,2035,4004,1593,47035,22555
Monte León,Única,PN,PATAGONIA,2017m4,4,2017,NO COBRA,43,38,112,36,0,0,50,279,236
Nahuel Huapi,Lago Mascardi,PN,PATAGONIA,2017m4,4,2017,COBRA,1850,6039,395,3956,485,0,460,13185,11335
Nahuel Huapi,Puerto Pañuelo,PN,PATAGONIA,2017m4,4,2017,COBRA,2756,6119,476,4065,475,0,563,14454,11698
Nahuel Huapi,Quetrihué,PN,PATAGONIA,2017m4,4,2017,COBRA,206,1501,823,759,318,0,128,3735,3529
Nahuel Huapi,Río Limay,PN,PATAGONIA,2017m4,4,2017,COBRA,0,0,0,0,0,0,0,0,0
Patagonia,Única,PN,PATAGONIA,2017m4,4,2017,NO COBRA,0,0,0,0,0,0,0,0,0
Perito Moreno,Única,PN,PATAGONIA,2017m4,4,2017,NO COBRA,1,18,18,0,0,0,1,38,37
Tierra del Fuego,Ruta Nacional 3,PN,PATAGONIA,2017m4,4,2017,COBRA,7209,4613,7914,0,784,2960,20,23500,16291
Tierra del Fuego,Tren del Fin del Mundo,PN,PATAGONIA,2017m4,4,2017,COBRA,3286,3465,341,0,149,1422,1018,9681,6395
Ciervo de los Pantanos,Única,PN,CENTRO,2017m5,5,2017,NO COBRA,1,42,294,141,85,1,315,879,878
El Leoncito,Única,PN,CENTRO,2017m5,5,2017,NO COBRA,139,577,870,138,0,0,0,1724,1585
El Palmar,Única,PN,CENTRO,2017m5,5,2017,COBRA,51,1839,1715,339,152,1258,808,6162,6111
Iberá,Cambyretá,PN,CENTRO,2017m5,5,2017,NO COBRA,0,0,0,0,0,0,0,0,0
Iberá,San Nicolás,PN,CENTRO,2017m5,5,2017,NO COBRA,0,0,0,0,0,0,0,0,0
Mburucuyá,Única,PN,CENTRO,2017m5,5,2017,NO COBRA,0,0,0,0,0,0,0,0,0
Pre Delta,Única,PN,CENTRO,2017m5,5,2017,NO COBRA,11,1853,2646,2842,28,236,1811,9427,9416
Quebrada del Condorito,Única,PN,CENTRO,2017m5,5,2017,NO COBRA,194,296,2430,231,0,0,0,3151,2957
San Guillermo,Única,PN,CENTRO,2017m5,5,2017,NO COBRA,0,3,0,0,0,0,0,3,3
Sierra de las Quijadas,Única,PN,CENTRO,2017m5,5,2017,COBRA,38,643,230,7,56,414,205,1593,1555
Talampaya,Única,PN,CENTRO,2017m5,5,2017,COBRA,310,3017,71,0,59,2686,303,6446,6136
Chaco,Única,PN,NEA,2017m5,5,2017,NO COBRA,20,99,387,134,0,0,182,822,802
Colonia Benítez,Única,RNEd,NEA,2017m5,5,2017,NO COBRA,0,0,0,251,0,0,0,251,251
El Impenetrable,Única,PN,NEA,2017m5,5,2017,NO COBRA,0,0,0,0,0,0,0,0,0
Formosa,Única,RNat,NEA,2017m5,5,2017,NO COBRA,0,0,0,0,0,0,0,0,0
Iguazú,Única,PN,NEA,2017m5,5,2017,COBRA,39868,22392,1861,1367,0,15268,10857,91613,51745
Río Pilcomayo,Estero Poi,PN,NEA,2017m5,5,2017,NO COBRA,16,34,24,29,2,0,3,108,92
Río Pilcomayo,Laguna Blanca,PN,NEA,2017m5,5,2017,NO COBRA,21,36,87,60,0,0,116,320,299
Aconquija,Única,PN,NOA,2017m5,5,2017,NO COBRA,0,5,31,51,95,0,2,184,184
Baritú,Única,PN,NOA,2017m5,5,2017,NO COBRA,0,2,0,2,0,0,0,4,4
Calilegua,Única,PN,NOA,2017m5,5,2017,NO COBRA,37,319,52,235,196,0,107,946,909
Copo,Guayacán,PN,NOA,2017m5,5,2017,NO COBRA,0,0,0,0,0,0,0,0,0
Copo,Portada,PN,NOA,2017m5,5,2017,NO COBRA,2,4,0,0,0,0,0,6,4
El Rey,Única,PN,NOA,2017m5,5,2017,NO COBRA,3,19,21,8,0,0,11,62,59
Laguna de los Pozuelos,Única,MN,NOA,2017m5,5,2017,NO COBRA,69,26,17,0,0,0,0,112,43
Los Cardones,Recta del Tín Tín,PN,NOA,2017m5,5,2017,NO COBRA,454,4405,262,68,0,3693,34,8916,8462
Los Cardones,Valle Encantado,PN,NOA,2017m5,5,2017,NO COBRA,0,0,0,0,0,0,0,0,0
Nogalar de los Toldos,Única,RNac,NOA,2017m5,5,2017,NO COBRA,2,0,0,60,0,0,0,62,60
Pizarro,Única,RNac,NOA,2017m5,5,2017,NO COBRA,0,0,0,0,0,0,0,0,0
Bosques Petrificados,Única,PN,PATAGONIA,2017m5,5,2017,NO COBRA,11,43,14,7,0,0,25,100,89
Lago Puelo,Única,PN,PATAGONIA,2017m5,5,2017,COBRA,40,1092,185,452,752,861,213,3595,3555
Laguna Blanca,Única,PN,PATAGONIA,2017m5,5,2017,NO COBRA,2,15,230,133,0,0,50,430,428
Lanín,Hua Hum,PN,PATAGONIA,2017m5,5,2017,NO COBRA,0,0,0,0,0,0,0,0,0
Lanín,Lago Huechulaufquen,PN,PATAGONIA,2017m5,5,2017,COBRA,0,272,0,0,0,0,0,272,272
Lanín,Muelle Lago Lácar,PN,PATAGONIA,2017m5,5,2017,COBRA,40,502,142,0,34,146,4,868,828
Lanín,Quila Quina,PN,PATAGONIA,2017m5,5,2017,COBRA,6,551,341,0,4,386,6,1294,1288
Lanín,Ruka Choroy,PN,PATAGONIA,2017m5,5,2017,NO COBRA,0,0,0,0,0,0,0,0,0
Lanín,Volcán Lanín,PN,PATAGONIA,2017m5,5,2017,NO COBRA,0,0,0,0,0,0,0,0,0
Lanín,Área Tromen,PN,PATAGONIA,2017m5,5,2017,NO COBRA,0,0,0,0,0,0,0,0,0
Lanín,Ñorkinko,PN,PATAGONIA,2017m5,5,2017,NO COBRA,0,0,0,0,0,0,0,0,0
Lihué Calel,Única,PN,PATAGONIA,2017m5,5,2017,NO COBRA,1,50,47,41,69,2,70,280,279
Los Alerces,Portada Centro,PN,PATAGONIA,2017m5,5,2017,COBRA,0,0,0,0,0,0,0,0,0
Los Alerces,Portada Norte,PN,PATAGONIA,2017m5,5,2017,COBRA,0,0,0,0,0,0,0,0,0
Los Alerces,Portada Sur,PN,PATAGONIA,2017m5,5,2017,COBRA,0,0,0,0,0,0,0,0,0
Los Alerces,Villa Futalaufquen,PN,PATAGONIA,2017m5,5,2017,NO COBRA,70,463,8,4,3,10,16,574,504
Los Glaciares,El Chaltén,PN,PATAGONIA,2017m5,5,2017,NO COBRA,1760,1400,0,0,0,0,0,3160,1400
Los Glaciares,Puerto Bandera,PN,PATAGONIA,2017m5,5,2017,COBRA,1007,2472,17,1041,147,0,139,4823,3816
Los Glaciares,Puerto La Cruz,PN,PATAGONIA,2017m5,5,2017,NO COBRA,0,0,0,0,0,0,0,0,0
Los Glaciares,Puerto La Soledad,PN,PATAGONIA,2017m5,5,2017,COBRA,97,35,12,506,2,0,21,673,576
Los Glaciares,Puerto Lago Argentino,PN,PATAGONIA,2017m5,5,2017,COBRA,0,0,0,0,0,0,0,0,0
Los Glaciares,Río Mitre,PN,PATAGONIA,2017m5,5,2017,COBRA,7458,7076,1217,1578,809,1560,749,20447,12989
Monte León,Única,PN,PATAGONIA,2017m5,5,2017,NO COBRA,0,0,0,0,0,0,0,0,0
Nahuel Huapi,Lago Mascardi,PN,PATAGONIA,2017m5,5,2017,COBRA,833,1659,37,2350,88,0,91,5058,4225
Nahuel Huapi,Puerto Pañuelo,PN,PATAGONIA,2017m5,5,2017,COBRA,1556,3892,57,4132,262,0,226,10125,8569
Nahuel Huapi,Quetrihué,PN,PATAGONIA,2017m5,5,2017,COBRA,69,708,91,0,222,389,24,1503,1434
Nahuel Huapi,Río Limay,PN,PATAGONIA,2017m5,5,2017,COBRA,0,0,0,0,0,0,0,0,0
Patagonia,Única,PN,PATAGONIA,2017m5,5,2017,NO COBRA,0,0,0,0,0,0,0,0,0
Perito Moreno,Única,PN,PATAGONIA,2017m5,5,2017,NO COBRA,0,0,0,0,0,0,0,0,0
Tierra del Fuego,Ruta Nacional 3,PN,PATAGONIA,2017m5,5,2017,COBRA,1907,2577,2788,0,40,67,212,7591,5684
Tierra del Fuego,Tren del Fin del Mundo,PN,PATAGONIA,2017m5,5,2017,COBRA,1833,2491,183,0,0,653,489,5649,3816
Ciervo de los Pantanos,Única,PN,CENTRO,2017m6,6,2017,NO COBRA,1,91,258,141,18,15,270,794,793
El Leoncito,Única,PN,CENTRO,2017m6,6,2017,NO COBRA,35,600,414,75,0,0,0,1124,1089
El Palmar,Única,PN,CENTRO,2017m6,6,2017,COBRA,24,1640,1249,270,225,1378,1550,6336,6312
Iberá,Cambyretá,PN,CENTRO,2017m6,6,2017,NO COBRA,0,0,0,0,0,0,0,0,0
Iberá,San Nicolás,PN,CENTRO,2017m6,6,2017,NO COBRA,0,0,0,0,0,0,0,0,0
Mburucuyá,Única,PN,CENTRO,2017m6,6,2017,NO COBRA,0,0,0,0,0,0,0,0,0
Pre Delta,Única,PN,CENTRO,2017m6,6,2017,NO COBRA,3,26,54,219,0,0,55,357,354
Quebrada del Condorito,Única,PN,CENTRO,2017m6,6,2017,NO COBRA,182,134,841,253,0,0,0,1410,1228
San Guillermo,Única,PN,CENTRO,2017m6,6,2017,NO COBRA,0,0,0,0,0,0,0,0,0
Sierra de las Quijadas,Única,PN,CENTRO,2017m6,6,2017,COBRA,22,408,150,11,54,190,66,901,879
Talampaya,Única,PN,CENTRO,2017m6,6,2017,COBRA,144,1904,78,0,67,2200,172,4565,4421
Chaco,Única,PN,NEA,2017m6,6,2017,NO COBRA,12,169,491,89,220,11,157,1149,1137
Colonia Benítez,Única,RNEd,NEA,2017m6,6,2017,NO COBRA,1,0,2,155,0,0,0,158,157
El Impenetrable,Única,PN,NEA,2017m6,6,2017,NO COBRA,0,0,0,0,0,0,0,0,0
Formosa,Única,RNat,NEA,2017m6,6,2017,NO COBRA,7,0,0,0,0,0,0,7,0
Iguazú,Única,PN,NEA,2017m6,6,2017,COBRA,45309,36457,1553,1799,943,17024,8780,111865,66556
Río Pilcomayo,Estero Poi,PN,NEA,2017m6,6,2017,NO COBRA,12,26,10,18,0,0,0,66,54
Río Pilcomayo,Laguna Blanca,PN,NEA,2017m6,6,2017,NO COBRA,24,37,84,108,62,0,44,359,335
Aconquija,Única,PN,NOA,2017m6,6,2017,NO COBRA,12,4,13,81,10,4,43,167,155
Baritú,Única,PN,NOA,2017m6,6,2017,NO COBRA,0,10,4,0,0,0,0,14,14
Calilegua,Única,PN,NOA,2017m6,6,2017,NO COBRA,66,505,147,442,326,144,115,1745,1679
Copo,Guayacán,PN,NOA,2017m6,6,2017,NO COBRA,0,0,0,0,0,0,0,0,0
Copo,Portada,PN,NOA,2017m6,6,2017,NO COBRA,0,3,0,0,0,0,0,3,3
El Rey,Única,PN,NOA,2017m6,6,2017,NO COBRA,112,0,0,0,0,0,36,148,36
Laguna de los Pozuelos,Única,MN,NOA,2017m6,6,2017,NO COBRA,28,20,22,0,0,0,2,72,44
Los Cardones,Recta del Tín Tín,PN,NOA,2017m6,6,2017,NO COBRA,946,9430,661,154,61,919,141,12312,11366
Los Cardones,Valle Encantado,PN,NOA,2017m6,6,2017,NO COBRA,0,0,0,0,0,0,0,0,0
Nogalar de los Toldos,Única,RNac,NOA,2017m6,6,2017,NO COBRA,52,4,34,50,0,0,0,140,88
Pizarro,Única,RNac,NOA,2017m6,6,2017,NO COBRA,0,0,0,0,0,0,0,0,0
Bosques Petrificados,Única,PN,PATAGONIA,2017m6,6,2017,NO COBRA,2,10,0,0,0,0,0,12,10
Lago Puelo,Única,PN,PATAGONIA,2017m6,6,2017,COBRA,404,180,214,0,0,0,631,1429,1025
Laguna Blanca,Única,PN,PATAGONIA,2017m6,6,2017,NO COBRA,0,34,67,27,0,0,1,129,129
Lanín,Hua Hum,PN,PATAGONIA,2017m6,6,2017,NO COBRA,0,0,0,0,0,0,0,0,0
Lanín,Lago Huechulaufquen,PN,PATAGONIA,2017m6,6,2017,COBRA,0,353,0,0,0,0,0,353,353
Lanín,Muelle Lago Lácar,PN,PATAGONIA,2017m6,6,2017,COBRA,44,450,125,0,23,0,49,691,647
Lanín,Quila Quina,PN,PATAGONIA,2017m6,6,2017,COBRA,2,180,79,0,57,0,1,319,317
Lanín,Ruka Choroy,PN,PATAGONIA,2017m6,6,2017,NO COBRA,0,0,0,0,0,0,0,0,0
Lanín,Volcán Lanín,PN,PATAGONIA,2017m6,6,2017,NO COBRA,0,0,0,0,0,0,0,0,0
Lanín,Área Tromen,PN,PATAGONIA,2017m6,6,2017,NO COBRA,0,0,0,0,0,0,0,0,0
Lanín,Ñorkinko,PN,PATAGONIA,2017m6,6,2017,NO COBRA,0,0,0,0,0,0,0,0,0
Lihué Calel,Única,PN,PATAGONIA,2017m6,6,2017,NO COBRA,3,12,26,24,0,0,13,78,75
Los Alerces,Portada Centro,PN,PATAGONIA,2017m6,6,2017,COBRA,0,0,0,0,0,0,0,0,0
Los Alerces,Portada Norte,PN,PATAGONIA,2017m6,6,2017,COBRA,0,0,0,0,0,0,0,0,0
Los Alerces,Portada Sur,PN,PATAGONIA,2017m6,6,2017,COBRA,0,0,0,0,0,0,0,0,0
Los Alerces,Villa Futalaufquen,PN,PATAGONIA,2017m6,6,2017,NO COBRA,21,80,0,0,0,0,3,104,83
Los Glaciares,El Chaltén,PN,PATAGONIA,2017m6,6,2017,NO COBRA,888,879,0,0,0,0,0,1767,879
Los Glaciares,Puerto Bandera,PN,PATAGONIA,2017m6,6,2017,COBRA,946,1731,1,789,244,0,99,3810,2864
Los Glaciares,Puerto La Cruz,PN,PATAGONIA,2017m6,6,2017,NO COBRA,0,0,0,0,0,0,0,0,0
Los Glaciares,Puerto La Soledad,PN,PATAGONIA,2017m6,6,2017,COBRA,0,37,0,0,0,0,0,37,37
Los Glaciares,Puerto Lago Argentino,PN,PATAGONIA,2017m6,6,2017,COBRA,0,0,0,0,0,0,0,0,0
Los Glaciares,Río Mitre,PN,PATAGONIA,2017m6,6,2017,COBRA,3789,3320,244,515,523,1150,565,10106,6317
Monte León,Única,PN,PATAGONIA,2017m6,6,2017,NO COBRA,0,0,0,0,0,0,0,0,0
Nahuel Huapi,Lago Mascardi,PN,PATAGONIA,2017m6,6,2017,COBRA,945,2103,23,1401,146,0,59,4677,3732
Nahuel Huapi,Puerto Pañuelo,PN,PATAGONIA,2017m6,6,2017,COBRA,2802,6947,67,2986,1790,0,708,15300,12498
Nahuel Huapi,Quetrihué,PN,PATAGONIA,2017m6,6,2017,COBRA,117,727,480,375,90,0,44,1833,1716
Nahuel Huapi,Río Limay,PN,PATAGONIA,2017m6,6,2017,COBRA,0,0,0,0,0,0,0,0,0
Patagonia,Única,PN,PATAGONIA,2017m6,6,2017,NO COBRA,0,0,0,0,0,0,0,0,0
Perito Moreno,Única,PN,PATAGONIA,2017m6,6,2017,NO COBRA,0,0,0,0,0,0,0,0,0
Tierra del Fuego,Ruta Nacional 3,PN,PATAGONIA,2017m6,6,2017,COBRA,999,2266,2032,0,0,55,477,5829,4830
Tierra del Fuego,Tren del Fin del Mundo,PN,PATAGONIA,2017m6,6,2017,COBRA,2478,2341,258,0,0,642,896,6615,4137
Ciervo de los Pantanos,Única,PN,CENTRO,2017m7,7,2017,NO COBRA,11,35,734,204,26,24,378,1412,1401
El Leoncito,Única,PN,CENTRO,2017m7,7,2017,NO COBRA,148,1992,2169,153,0,0,0,4462,4314
El Palmar,Única,PN,CENTRO,2017m7,7,2017,COBRA,61,8483,4800,628,1353,2407,6624,24356,24295
Iberá,Cambyretá,PN,CENTRO,2017m7,7,2017,NO COBRA,22,511,0,0,0,0,0,533,511
Iberá,San Nicolás,PN,CENTRO,2017m7,7,2017,NO COBRA,0,0,0,0,0,0,0,0,0
Mburucuyá,Única,PN,CENTRO,2017m7,7,2017,NO COBRA,25,291,235,274,0,0,296,1121,1096
Pre Delta,Única,PN,CENTRO,2017m7,7,2017,NO COBRA,0,0,0,0,0,0,0,0,0
Quebrada del Condorito,Única,PN,CENTRO,2017m7,7,2017,NO COBRA,359,2130,1541,83,0,0,0,4113,3754
San Guillermo,Única,PN,CENTRO,2017m7,7,2017,NO COBRA,8,4,4,1,0,0,0,17,9
Sierra de las Quijadas,Única,PN,CENTRO,2017m7,7,2017,COBRA,41,3305,497,4,443,901,844,6035,5994
Talampaya,Única,PN,CENTRO,2017m7,7,2017,COBRA,244,8705,318,0,802,3674,3624,17367,17123
Chaco,Única,PN,NEA,2017m7,7,2017,NO COBRA,13,434,224,410,2,12,453,1548,1535
Colonia Benítez,Única,RNEd,NEA,2017m7,7,2017,NO COBRA,0,0,0,0,0,0,0,0,0
El Impenetrable,Única,PN,NEA,2017m7,7,2017,NO COBRA,0,0,0,0,0,0,0,0,0
Formosa,Única,RNat,NEA,2017m7,7,2017,NO COBRA,14,32,0,1,0,0,3,50,36
Iguazú,Única,PN,NEA,2017m7,7,2017,COBRA,51222,139322,10912,2653,374,21169,50322,275974,224752
Río Pilcomayo,Estero Poi,PN,NEA,2017m7,7,2017,NO COBRA,42,99,96,128,12,0,124,501,459
Río Pilcomayo,Laguna Blanca,PN,NEA,2017m7,7,2017,NO COBRA,103,556,644,494,0,57,959,2813,2710
Aconquija,Única,PN,NOA,2017m7,7,2017,NO COBRA,2,83,25,161,86,0,101,458,456
Baritú,Única,PN,NOA,2017m7,7,2017,NO COBRA,63,76,30,15,0,0,0,184,121
Calilegua,Única,PN,NOA,2017m7,7,2017,NO COBRA,206,1593,582,571,225,16,833,4026,3820
Copo,Guayacán,PN,NOA,2017m7,7,2017,NO COBRA,0,0,0,0,0,0,0,0,0
Copo,Portada,PN,NOA,2017m7,7,2017,NO COBRA,3,22,0,0,0,0,0,25,22
El Rey,Única,PN,NOA,2017m7,7,2017,NO COBRA,53,130,174,71,0,0,94,522,469
Laguna de los Pozuelos,Única,MN,NOA,2017m7,7,2017,NO COBRA,60,97,35,3,1,0,36,232,172
Los Cardones,Recta del Tín Tín,PN,NOA,2017m7,7,2017,NO COBRA,471,13070,802,222,73,1382,361,16381,15910
Los Cardones,Valle Encantado,PN,NOA,2017m7,7,2017,NO COBRA,0,0,0,0,0,0,0,0,0
Nogalar de los Toldos,Única,RNac,NOA,2017m7,7,2017,NO COBRA,18,48,78,167,0,0,0,311,293
Pizarro,Única,RNac,NOA,2017m7,7,2017,NO COBRA,0,0,0,0,0,0,0,0,0
Bosques Petrificados,Única,PN,PATAGONIA,2017m7,7,2017,NO COBRA,14,34,27,28,3,0,44,150,136
Lago Puelo,Única,PN,PATAGONIA,2017m7,7,2017,COBRA,0,2031,0,0,0,0,0,2031,2031
Laguna Blanca,Única,PN,PATAGONIA,2017m7,7,2017,NO COBRA,3,95,27,63,0,0,57,245,242
Lanín,Hua Hum,PN,PATAGONIA,2017m7,7,2017,NO COBRA,0,0,0,0,0,0,0,0,0
Lanín,Lago Huechulaufquen,PN,PATAGONIA,2017m7,7,2017,COBRA,198,0,1796,0,0,0,0,1994,1796
Lanín,Muelle Lago Lácar,PN,PATAGONIA,2017m7,7,2017,COBRA,202,1692,513,0,376,213,540,3536,3334
Lanín,Quila Quina,PN,PATAGONIA,2017m7,7,2017,COBRA,0,417,136,0,27,124,31,735,735
Lanín,Ruka Choroy,PN,PATAGONIA,2017m7,7,2017,NO COBRA,0,0,0,0,0,0,0,0,0
Lanín,Volcán Lanín,PN,PATAGONIA,2017m7,7,2017,NO COBRA,0,0,0,0,0,0,0,0,0
Lanín,Área Tromen,PN,PATAGONIA,2017m7,7,2017,NO COBRA,0,0,0,0,0,0,0,0,0
Lanín,Ñorkinko,PN,PATAGONIA,2017m7,7,2017,NO COBRA,0,0,0,0,0,0,0,0,0
Lihué Calel,Única,PN,PATAGONIA,2017m7,7,2017,NO COBRA,2,150,131,55,0,1,87,426,424
Los Alerces,Portada Centro,PN,PATAGONIA,2017m7,7,2017,COBRA,0,0,0,0,0,0,0,0,0
Los Alerces,Portada Norte,PN,PATAGONIA,2017m7,7,2017,COBRA,0,0,0,0,0,0,0,0,0
Los Alerces,Portada Sur,PN,PATAGONIA,2017m7,7,2017,COBRA,0,0,0,0,0,0,0,0,0
Los Alerces,Villa Futalaufquen,PN,PATAGONIA,2017m7,7,2017,NO COBRA,44,733,0,1,0,0,56,834,790
Los Glaciares,El Chaltén,PN,PATAGONIA,2017m7,7,2017,NO COBRA,668,2246,0,0,0,0,0,2914,2246
Los Glaciares,Puerto Bandera,PN,PATAGONIA,2017m7,7,2017,COBRA,1256,2666,47,339,286,0,599,5193,3937
Los Glaciares,Puerto La Cruz,PN,PATAGONIA,2017m7,7,2017,NO COBRA,0,0,0,0,0,0,0,0,0
Los Glaciares,Puerto La Soledad,PN,PATAGONIA,2017m7,7,2017,COBRA,0,0,0,0,0,0,0,0,0
Los Glaciares,Puerto Lago Argentino,PN,PATAGONIA,2017m7,7,2017,COBRA,0,0,0,0,0,0,0,0,0
Los Glaciares,Río Mitre,PN,PATAGONIA,2017m7,7,2017,COBRA,6771,5436,1901,2217,1232,658,2198,20413,13642
Monte León,Única,PN,PATAGONIA,2017m7,7,2017,NO COBRA,0,0,0,0,0,0,0,0,0
Nahuel Huapi,Lago Mascardi,PN,PATAGONIA,2017m7,7,2017,COBRA,2524,3430,148,845,378,0,504,7829,5305
Nahuel Huapi,Puerto Pañuelo,PN,PATAGONIA,2017m7,7,2017,COBRA,9357,14392,814,3422,13572,0,4754,46311,36954
Nahuel Huapi,Quetrihué,PN,PATAGONIA,2017m7,7,2017,COBRA,718,1315,860,859,1391,0,1236,6379,5661
Nahuel Huapi,Río Limay,PN,PATAGONIA,2017m7,7,2017,COBRA,0,0,0,0,0,0,0,0,0
Patagonia,Única,PN,PATAGONIA,2017m7,7,2017,NO COBRA,0,0,0,0,0,0,0,0,0
Perito Moreno,Única,PN,PATAGONIA,2017m7,7,2017,NO COBRA,0,0,0,0,0,0,0,0,0
Tierra del Fuego,Ruta Nacional 3,PN,PATAGONIA,2017m7,7,2017,COBRA,1759,4829,6373,0,0,78,1523,14562,12803
Tierra del Fuego,Tren del Fin del Mundo,PN,PATAGONIA,2017m7,7,2017,COBRA,5278,4922,1004,0,0,478,2982,14664,9386
Ciervo de los Pantanos,Única,PN,CENTRO,2017m8,8,2017,NO COBRA,8,168,580,342,0,1,196,1295,1287
El Leoncito,Única,PN,CENTRO,2017m8,8,2017,NO COBRA,54,452,603,235,0,0,0,1344,1290
El Palmar,Única,PN,CENTRO,2017m8,8,2017,COBRA,120,3693,2858,868,453,880,3178,12050,11930
Iberá,Cambyretá,PN,CENTRO,2017m8,8,2017,NO COBRA,27,312,0,0,0,0,0,339,312
Iberá,San Nicolás,PN,CENTRO,2017m8,8,2017,NO COBRA,0,0,0,0,0,0,0,0,0
Mburucuyá,Única,PN,CENTRO,2017m8,8,2017,NO COBRA,14,157,121,162,0,0,170,624,610
Pre Delta,Única,PN,CENTRO,2017m8,8,2017,NO COBRA,0,0,0,0,0,0,0,0,0
Quebrada del Condorito,Única,PN,CENTRO,2017m8,8,2017,NO COBRA,379,799,1508,143,0,0,0,2829,2450
San Guillermo,Única,PN,CENTRO,2017m8,8,2017,NO COBRA,0,0,0,0,0,0,0,0,0
Sierra de las Quijadas,Única,PN,CENTRO,2017m8,8,2017,COBRA,35,1293,454,8,64,410,127,2391,2356
Talampaya,Única,PN,CENTRO,2017m8,8,2017,COBRA,336,4012,138,0,364,4492,457,9799,9463
Chaco,Única,PN,NEA,2017m8,8,2017,NO COBRA,0,0,0,0,0,0,0,0,0
Colonia Benítez,Única,RNEd,NEA,2017m8,8,2017,NO COBRA,0,156,0,0,0,0,0,156,156
El Impenetrable,Única,PN,NEA,2017m8,8,2017,NO COBRA,0,0,0,0,0,0,0,0,0
Formosa,Única,RNat,NEA,2017m8,8,2017,NO COBRA,0,10,0,0,43,0,0,53,53
Iguazú,Única,PN,NEA,2017m8,8,2017,COBRA,55419,75127,3063,1678,0,27360,15469,178116,122697
Río Pilcomayo,Estero Poi,PN,NEA,2017m8,8,2017,NO COBRA,28,86,19,58,13,2,23,229,201
Río Pilcomayo,Laguna Blanca,PN,NEA,2017m8,8,2017,NO COBRA,40,131,461,859,297,0,0,1788,1748
Aconquija,Única,PN,NOA,2017m8,8,2017,NO COBRA,0,48,35,199,0,0,62,344,344
Baritú,Única,PN,NOA,2017m8,8,2017,NO COBRA,93,53,69,1,0,0,0,216,123
Calilegua,Única,PN,NOA,2017m8,8,2017,NO COBRA,158,1168,163,458,217,0,218,2382,2224
Copo,Guayacán,PN,NOA,2017m8,8,2017,NO COBRA,0,0,0,0,0,0,0,0,0
Copo,Portada,PN,NOA,2017m8,8,2017,NO COBRA,0,11,0,0,0,0,0,11,11
El Rey,Única,PN,NOA,2017m8,8,2017,NO COBRA,14,78,52,0,0,0,33,177,163
Laguna de los Pozuelos,Única,MN,NOA,2017m8,8,2017,NO COBRA,48,35,23,0,2,0,6,114,66
Los Cardones,Recta del Tín Tín,PN,NOA,2017m8,8,2017,NO COBRA,333,10607,444,463,0,1125,107,13079,12746
Los Cardones,Valle Encantado,PN,NOA,2017m8,8,2017,NO COBRA,0,0,0,0,0,0,0,0,0
Nogalar de los Toldos,Única,RNac,NOA,2017m8,8,2017,NO COBRA,35,19,41,183,0,0,0,278,243
Pizarro,Única,RNac,NOA,2017m8,8,2017,NO COBRA,0,0,0,0,0,0,0,0,0
Bosques Petrificados,Única,PN,PATAGONIA,2017m8,8,2017,NO COBRA,7,40,23,0,0,0,10,80,73
Lago Puelo,Única,PN,PATAGONIA,2017m8,8,2017,COBRA,0,6538,0,0,0,0,0,6538,6538
Laguna Blanca,Única,PN,PATAGONIA,2017m8,8,2017,NO COBRA,3,32,42,14,91,10,8,200,197
Lanín,Hua Hum,PN,PATAGONIA,2017m8,8,2017,NO COBRA,0,0,0,0,0,0,0,0,0
Lanín,Lago Huechulaufquen,PN,PATAGONIA,2017m8,8,2017,COBRA,0,0,0,0,0,0,0,0,0
Lanín,Muelle Lago Lácar,PN,PATAGONIA,2017m8,8,2017,COBRA,110,1066,441,0,76,259,193,2145,2035
Lanín,Quila Quina,PN,PATAGONIA,2017m8,8,2017,COBRA,3,143,23,0,31,0,7,207,204
Lanín,Ruka Choroy,PN,PATAGONIA,2017m8,8,2017,NO COBRA,0,0,0,0,0,0,0,0,0
Lanín,Volcán Lanín,PN,PATAGONIA,2017m8,8,2017,NO COBRA,0,0,0,0,0,0,0,0,0
Lanín,Área Tromen,PN,PATAGONIA,2017m8,8,2017,NO COBRA,0,0,0,0,0,0,0,0,0
Lanín,Ñorkinko,PN,PATAGONIA,2017m8,8,2017,NO COBRA,0,0,0,0,0,0,0,0,0
Lihué Calel,Única,PN,PATAGONIA,2017m8,8,2017,NO COBRA,14,78,54,23,91,3,44,307,293
Los Alerces,Portada Centro,PN,PATAGONIA,2017m8,8,2017,COBRA,0,0,0,0,0,0,0,0,0
Los Alerces,Portada Norte,PN,PATAGONIA,2017m8,8,2017,COBRA,0,0,0,0,0,0,0,0,0
Los Alerces,Portada Sur,PN,PATAGONIA,2017m8,8,2017,COBRA,0,0,0,0,0,0,0,0,0
Los Alerces,Villa Futalaufquen,PN,PATAGONIA,2017m8,8,2017,NO COBRA,80,676,0,0,0,0,197,953,873
Los Glaciares,El Chaltén,PN,PATAGONIA,2017m8,8,2017,NO COBRA,1088,2625,0,0,0,0,0,3713,2625
Los Glaciares,Puerto Bandera,PN,PATAGONIA,2017m8,8,2017,COBRA,1853,2495,17,633,250,0,218,5466,3613
Los Glaciares,Puerto La Cruz,PN,PATAGONIA,2017m8,8,2017,NO COBRA,0,0,0,0,0,0,0,0,0
Los Glaciares,Puerto La Soledad,PN,PATAGONIA,2017m8,8,2017,COBRA,653,395,27,160,73,0,86,1394,741
Los Glaciares,Puerto Lago Argentino,PN,PATAGONIA,2017m8,8,2017,COBRA,0,0,0,0,0,0,0,0,0
Los Glaciares,Río Mitre,PN,PATAGONIA,2017m8,8,2017,COBRA,6098,6954,971,1449,691,1300,1167,18630,12532
Monte León,Única,PN,PATAGONIA,2017m8,8,2017,NO COBRA,0,0,0,0,0,0,0,0,0
Nahuel Huapi,Lago Mascardi,PN,PATAGONIA,2017m8,8,2017,COBRA,1338,3070,100,764,159,0,80,5511,4173
Nahuel Huapi,Puerto Pañuelo,PN,PATAGONIA,2017m8,8,2017,COBRA,5865,7237,728,1346,13460,980,0,29616,23751
Nahuel Huapi,Quetrihué,PN,PATAGONIA,2017m8,8,2017,COBRA,334,1013,461,975,455,0,237,3475,3141
Nahuel Huapi,Río Limay,PN,PATAGONIA,2017m8,8,2017,COBRA,0,0,0,0,0,0,0,0,0
Patagonia,Única,PN,PATAGONIA,2017m8,8,2017,NO COBRA,0,0,0,0,0,0,0,0,0
Perito Moreno,Única,PN,PATAGONIA,2017m8,8,2017,NO COBRA,0,0,0,0,0,0,0,0,0
Tierra del Fuego,Ruta Nacional 3,PN,PATAGONIA,2017m8,8,2017,COBRA,1917,4122,3542,0,41,78,700,10400,8483
Tierra del Fuego,Tren del Fin del Mundo,PN,PATAGONIA,2017m8,8,2017,COBRA,3501,3241,475,0,0,567,1123,8907,5406
Ciervo de los Pantanos,Única,PN,CENTRO,2017m9,9,2017,NO COBRA,1,15,962,166,2,4,506,1656,1655
El Leoncito,Única,PN,CENTRO,2017m9,9,2017,NO COBRA,95,727,1239,541,0,0,0,2602,2507
El Palmar,Única,PN,CENTRO,2017m9,9,2017,COBRA,76,2900,2693,2752,634,1644,8966,19665,19589
Iberá,Cambyretá,PN,CENTRO,2017m9,9,2017,NO COBRA,69,239,64,0,2,126,28,528,459
Iberá,San Nicolás,PN,CENTRO,2017m9,9,2017,NO COBRA,0,0,0,0,0,0,0,0,0
Mburucuyá,Única,PN,CENTRO,2017m9,9,2017,NO COBRA,4,120,100,154,0,10,336,724,720
Pre Delta,Única,PN,CENTRO,2017m9,9,2017,NO COBRA,144,1807,2762,2573,268,177,1960,9691,9547
Quebrada del Condorito,Única,PN,CENTRO,2017m9,9,2017,NO COBRA,347,336,1108,236,0,0,0,2027,1680
San Guillermo,Única,PN,CENTRO,2017m9,9,2017,NO COBRA,0,2,0,21,0,0,0,23,23
Sierra de las Quijadas,Única,PN,CENTRO,2017m9,9,2017,COBRA,62,488,115,0,332,424,106,1527,1465
Talampaya,Única,PN,CENTRO,2017m9,9,2017,COBRA,361,3308,331,0,294,2176,297,6767,6406
Chaco,Única,PN,NEA,2017m9,9,2017,NO COBRA,0,0,0,0,0,0,0,0,0
Colonia Benítez,Única,RNEd,NEA,2017m9,9,2017,NO COBRA,0,123,0,0,0,0,235,358,358
El Impenetrable,Única,PN,NEA,2017m9,9,2017,NO COBRA,0,0,0,0,0,0,0,0,0
Formosa,Única,RNat,NEA,2017m9,9,2017,NO COBRA,2,11,33,20,57,0,20,143,141
Iguazú,Única,PN,NEA,2017m9,9,2017,COBRA,59015,77978,3130,2509,0,29172,24586,196390,137375
Río Pilcomayo,Estero Poi,PN,NEA,2017m9,9,2017,NO COBRA,0,68,22,49,2,0,60,201,201
Río Pilcomayo,Laguna Blanca,PN,NEA,2017m9,9,2017,NO COBRA,19,53,125,739,0,0,453,1389,1370
Aconquija,Única,PN,NOA,2017m9,9,2017,NO COBRA,0,39,116,153,90,0,96,494,494
Baritú,Única,PN,NOA,2017m9,9,2017,NO COBRA,4,37,24,2,0,0,0,67,63
Calilegua,Única,PN,NOA,2017m9,9,2017,NO COBRA,185,490,230,344,792,0,79,2120,1935
Copo,Guayacán,PN,NOA,2017m9,9,2017,NO COBRA,0,0,0,0,0,0,0,0,0
Copo,Portada,PN,NOA,2017m9,9,2017,NO COBRA,0,22,0,0,0,0,0,22,22
El Rey,Única,PN,NOA,2017m9,9,2017,NO COBRA,10,46,54,0,0,0,53,163,153
Laguna de los Pozuelos,Única,MN,NOA,2017m9,9,2017,NO COBRA,28,37,8,0,0,0,2,75,47
Los Cardones,Recta del Tín Tín,PN,NOA,2017m9,9,2017,NO COBRA,558,12530,310,128,28,1079,55,14688,14130
Los Cardones,Valle Encantado,PN,NOA,2017m9,9,2017,NO COBRA,0,0,0,0,0,0,0,0,0
Nogalar de los Toldos,Única,RNac,NOA,2017m9,9,2017,NO COBRA,0,13,37,57,265,0,0,372,372
Pizarro,Única,RNac,NOA,2017m9,9,2017,NO COBRA,0,0,0,0,0,0,0,0,0
Bosques Petrificados,Única,PN,PATAGONIA,2017m9,9,2017,NO COBRA,9,40,33,20,0,6,10,118,109
Lago Puelo,Única,PN,PATAGONIA,2017m9,9,2017,COBRA,146,3152,595,2586,106,2185,1684,10454,10308
Laguna Blanca,Única,PN,PATAGONIA,2017m9,9,2017,NO COBRA,3,23,61,52,0,1,20,160,157
Lanín,Hua Hum,PN,PATAGONIA,2017m9,9,2017,NO COBRA,0,0,0,0,0,0,0,0,0
Lanín,Lago Huechulaufquen,PN,PATAGONIA,2017m9,9,2017,COBRA,0,303,0,0,0,0,0,303,303
Lanín,Muelle Lago Lácar,PN,PATAGONIA,2017m9,9,2017,COBRA,94,819,352,0,325,231,118,1939,1845
Lanín,Quila Quina,PN,PATAGONIA,2017m9,9,2017,COBRA,23,340,138,0,48,278,0,827,804
Lanín,Ruka Choroy,PN,PATAGONIA,2017m9,9,2017,NO COBRA,0,0,0,0,0,0,0,0,0
Lanín,Volcán Lanín,PN,PATAGONIA,2017m9,9,2017,NO COBRA,0,0,0,0,0,0,0,0,0
Lanín,Área Tromen,PN,PATAGONIA,2017m9,9,2017,NO COBRA,0,0,0,0,0,0,0,0,0
Lanín,Ñorkinko,PN,PATAGONIA,2017m9,9,2017,NO COBRA,0,0,0,0,0,0,0,0,0
Lihué Calel,Única,PN,PATAGONIA,2017m9,9,2017,NO COBRA,12,88,88,39,692,1,26,946,934
Los Alerces,Portada Centro,PN,PATAGONIA,2017m9,9,2017,COBRA,0,0,0,0,0,0,0,0,0
Los Alerces,Portada Norte,PN,PATAGONIA,2017m9,9,2017,COBRA,0,0,0,0,0,0,0,0,0
Los Alerces,Portada Sur,PN,PATAGONIA,2017m9,9,2017,COBRA,0,0,0,0,0,0,0,0,0
Los Alerces,Villa Futalaufquen,PN,PATAGONIA,2017m9,9,2017,NO COBRA,67,880,3,0,180,0,150,1280,1213
Los Glaciares,El Chaltén,PN,PATAGONIA,2017m9,9,2017,NO COBRA,1795,4996,0,0,0,0,0,6791,4996
Los Glaciares,Puerto Bandera,PN,PATAGONIA,2017m9,9,2017,COBRA,3788,6004,11,3121,337,0,427,13688,9900
Los Glaciares,Puerto La Cruz,PN,PATAGONIA,2017m9,9,2017,NO COBRA,0,0,0,0,0,0,0,0,0
Los Glaciares,Puerto La Soledad,PN,PATAGONIA,2017m9,9,2017,COBRA,19,29,0,0,0,0,0,48,29
Los Glaciares,Puerto Lago Argentino,PN,PATAGONIA,2017m9,9,2017,COBRA,0,0,0,0,0,0,0,0,0
Los Glaciares,Río Mitre,PN,PATAGONIA,2017m9,9,2017,COBRA,15936,8459,2675,1635,2104,5576,2349,38734,22798
Monte León,Única,PN,PATAGONIA,2017m9,9,2017,NO COBRA,0,0,0,0,0,0,0,0,0
Nahuel Huapi,Lago Mascardi,PN,PATAGONIA,2017m9,9,2017,COBRA,1046,1878,28,1238,336,0,115,4641,3595
Nahuel Huapi,Puerto Pañuelo,PN,PATAGONIA,2017m9,9,2017,COBRA,5147,6699,250,4179,17233,0,1304,34812,29665
Nahuel Huapi,Quetrihué,PN,PATAGONIA,2017m9,9,2017,COBRA,354,2202,481,1783,404,0,281,5505,5151
Nahuel Huapi,Río Limay,PN,PATAGONIA,2017m9,9,2017,COBRA,0,0,0,0,0,0,0,0,0
Patagonia,Única,PN,PATAGONIA,2017m9,9,2017,NO COBRA,0,0,0,0,0,0,0,0,0
Perito Moreno,Única,PN,PATAGONIA,2017m9,9,2017,NO COBRA,0,0,0,0,0,0,0,0,0
Tierra del Fuego,Ruta Nacional 3,PN,PATAGONIA,2017m9,9,2017,COBRA,3222,4827,4695,0,113,113,1748,14718,11496
Tierra del Fuego,Tren del Fin del Mundo,PN,PATAGONIA,2017m9,9,2017,COBRA,2836,4729,287,0,0,1688,1266,10806,7970
Ciervo de los Pantanos,Única,PN,CENTRO,2017m10,10,2017,NO COBRA,17,315,299,184,6,11,734,1566,1549
El Leoncito,Única,PN,CENTRO,2017m10,10,2017,NO COBRA,155,751,663,312,0,0,0,1881,1726
El Palmar,Única,PN,CENTRO,2017m10,10,2017,COBRA,179,6475,2988,909,2124,5121,15436,33232,33053
Iberá,Cambyretá,PN,CENTRO,2017m10,10,2017,NO COBRA,61,80,26,0,80,82,17,346,285
Iberá,San Nicolás,PN,CENTRO,2017m10,10,2017,NO COBRA,0,0,0,0,0,0,0,0,0
Mburucuyá,Única,PN,CENTRO,2017m10,10,2017,NO COBRA,9,155,92,189,0,0,140,585,576
Pre Delta,Única,PN,CENTRO,2017m10,10,2017,NO COBRA,13,2562,5314,5573,653,141,2210,16466,16453
Quebrada del Condorito,Única,PN,CENTRO,2017m10,10,2017,NO COBRA,272,438,2278,742,0,0,0,3730,3458
San Guillermo,Única,PN,CENTRO,2017m10,10,2017,NO COBRA,0,0,0,0,0,0,0,0,0
Sierra de las Quijadas,Única,PN,CENTRO,2017m10,10,2017,COBRA,58,753,130,3,285,332,81,1642,1584
Talampaya,Única,PN,CENTRO,2017m10,10,2017,COBRA,947,3172,213,0,527,5163,152,10174,9227
Chaco,Única,PN,NEA,2017m10,10,2017,NO COBRA,0,0,0,0,0,0,0,0,0
Colonia Benítez,Única,RNEd,NEA,2017m10,10,2017,NO COBRA,0,0,0,0,0,0,0,0,0
El Impenetrable,Única,PN,NEA,2017m10,10,2017,NO COBRA,0,0,0,0,0,0,0,0,0
Formosa,Única,RNat,NEA,2017m10,10,2017,NO COBRA,8,3,0,10,0,0,0,21,13
Iguazú,Única,PN,NEA,2017m10,10,2017,COBRA,76194,72338,4960,2239,0,19049,28675,203455,127261
Río Pilcomayo,Estero Poi,PN,NEA,2017m10,10,2017,NO COBRA,0,69,22,59,2,0,64,216,216
Río Pilcomayo,Laguna Blanca,PN,NEA,2017m10,10,2017,NO COBRA,26,361,811,2479,0,0,1295,4972,4946
Aconquija,Única,PN,NOA,2017m10,10,2017,NO COBRA,2,44,74,326,45,2,191,684,682
Baritú,Única,PN,NOA,2017m10,10,2017,NO COBRA,2,35,8,6,41,0,0,92,90
Calilegua,Única,PN,NOA,2017m10,10,2017,NO COBRA,226,826,452,484,346,0,205,2539,2313
Copo,Guayacán,PN,NOA,2017m10,10,2017,NO COBRA,0,0,0,0,0,0,0,0,0
Copo,Portada,PN,NOA,2017m10,10,2017,NO COBRA,7,20,0,0,0,0,0,27,20
El Rey,Única,PN,NOA,2017m10,10,2017,NO COBRA,27,81,109,0,0,0,189,406,379
Laguna de los Pozuelos,Única,MN,NOA,2017m10,10,2017,NO COBRA,91,41,13,0,0,0,0,145,54
Los Cardones,Recta del Tín Tín,PN,NOA,2017m10,10,2017,NO COBRA,425,9244,414,112,198,1732,78,12203,11778
Los Cardones,Valle Encantado,PN,NOA,2017m10,10,2017,NO COBRA,0,0,0,0,0,0,0,0,0
Nogalar de los Toldos,Única,RNac,NOA,2017m10,10,2017,NO COBRA,0,10,17,15,59,0,0,101,101
Pizarro,Única,RNac,NOA,2017m10,10,2017,NO COBRA,0,0,0,0,0,0,0,0,0
Bosques Petrificados,Única,PN,PATAGONIA,2017m10,10,2017,NO COBRA,69,84,22,46,3,69,38,331,262
Lago Puelo,Única,PN,PATAGONIA,2017m10,10,2017,COBRA,158,2885,804,2996,255,1347,1677,10122,9964
Laguna Blanca,Única,PN,PATAGONIA,2017m10,10,2017,NO COBRA,29,112,58,113,0,0,0,312,283
Lanín,Hua Hum,PN,PATAGONIA,2017m10,10,2017,NO COBRA,0,0,0,0,0,0,0,0,0
Lanín,Lago Huechulaufquen,PN,PATAGONIA,2017m10,10,2017,COBRA,0,944,0,0,168,1260,333,2705,2705
Lanín,Muelle Lago Lácar,PN,PATAGONIA,2017m10,10,2017,COBRA,136,1389,576,0,305,421,107,2934,2798
Lanín,Quila Quina,PN,PATAGONIA,2017m10,10,2017,COBRA,2,558,397,0,150,302,0,1409,1407
Lanín,Ruka Choroy,PN,PATAGONIA,2017m10,10,2017,NO COBRA,0,0,0,0,0,0,0,0,0
Lanín,Volcán Lanín,PN,PATAGONIA,2017m10,10,2017,NO COBRA,0,0,0,0,0,0,0,0,0
Lanín,Área Tromen,PN,PATAGONIA,2017m10,10,2017,NO COBRA,0,0,0,0,0,0,0,0,0
Lanín,Ñorkinko,PN,PATAGONIA,2017m10,10,2017,NO COBRA,0,0,0,0,0,0,0,0,0
Lihué Calel,Única,PN,PATAGONIA,2017m10,10,2017,NO COBRA,12,93,268,94,742,11,160,1380,1368
Los Alerces,Portada Centro,PN,PATAGONIA,2017m10,10,2017,COBRA,0,0,0,0,0,0,0,0,0
Los Alerces,Portada Norte,PN,PATAGONIA,2017m10,10,2017,COBRA,0,0,0,0,0,0,0,0,0
Los Alerces,Portada Sur,PN,PATAGONIA,2017m10,10,2017,COBRA,0,0,0,0,0,0,0,0,0
Los Alerces,Villa Futalaufquen,PN,PATAGONIA,2017m10,10,2017,NO COBRA,393,1226,0,14,0,167,175,1975,1582
Los Glaciares,El Chaltén,PN,PATAGONIA,2017m10,10,2017,NO COBRA,3980,6026,0,0,0,0,0,10006,6026
Los Glaciares,Puerto Bandera,PN,PATAGONIA,2017m10,10,2017,COBRA,5706,5726,13,4443,384,0,470,16742,11036
Los Glaciares,Puerto La Cruz,PN,PATAGONIA,2017m10,10,2017,NO COBRA,0,0,0,0,0,0,0,0,0
Los Glaciares,Puerto La Soledad,PN,PATAGONIA,2017m10,10,2017,COBRA,1301,264,0,0,0,0,0,1565,264
Los Glaciares,Puerto Lago Argentino,PN,PATAGONIA,2017m10,10,2017,COBRA,0,0,0,0,0,0,0,0,0
Los Glaciares,Río Mitre,PN,PATAGONIA,2017m10,10,2017,COBRA,31607,12438,3261,3523,1533,5933,2897,61192,29585
Monte León,Única,PN,PATAGONIA,2017m10,10,2017,NO COBRA,0,0,0,0,0,0,0,0,0
Nahuel Huapi,Lago Mascardi,PN,PATAGONIA,2017m10,10,2017,COBRA,1454,1905,1258,2432,252,0,99,7400,5946
Nahuel Huapi,Puerto Pañuelo,PN,PATAGONIA,2017m10,10,2017,COBRA,2847,9028,348,6727,12686,0,822,32458,29611
Nahuel Huapi,Quetrihué,PN,PATAGONIA,2017m10,10,2017,COBRA,369,1614,1132,1437,1343,0,207,6102,5733
Nahuel Huapi,Río Limay,PN,PATAGONIA,2017m10,10,2017,COBRA,0,0,289,0,3182,0,0,3471,3471
Patagonia,Única,PN,PATAGONIA,2017m10,10,2017,NO COBRA,0,0,0,0,0,0,0,0,0
Perito Moreno,Única,PN,PATAGONIA,2017m10,10,2017,NO COBRA,2,8,26,3,0,0,9,48,46
Tierra del Fuego,Ruta Nacional 3,PN,PATAGONIA,2017m10,10,2017,COBRA,4529,2883,11135,0,18,35,316,18916,14387
Tierra del Fuego,Tren del Fin del Mundo,PN,PATAGONIA,2017m10,10,2017,COBRA,6537,7859,471,0,0,2742,939,18548,12011
Ciervo de los Pantanos,Única,PN,CENTRO,2017m11,11,2017,NO COBRA,4,195,731,175,83,7,500,1695,1691
El Leoncito,Única,PN,CENTRO,2017m11,11,2017,NO COBRA,305,666,1571,277,0,0,0,2819,2514
El Palmar,Única,PN,CENTRO,2017m11,11,2017,COBRA,148,5919,3145,504,730,3767,15454,29667,29519
Iberá,Cambyretá,PN,CENTRO,2017m11,11,2017,NO COBRA,37,75,59,0,68,23,25,287,250
Iberá,San Nicolás,PN,CENTRO,2017m11,11,2017,NO COBRA,0,0,0,0,0,0,0,0,0
Mburucuyá,Única,PN,CENTRO,2017m11,11,2017,NO COBRA,9,110,232,156,22,2,188,719,710
Pre Delta,Única,PN,CENTRO,2017m11,11,2017,NO COBRA,70,2174,3251,2965,655,79,1231,10425,10355
Quebrada del Condorito,Única,PN,CENTRO,2017m11,11,2017,NO COBRA,433,477,1851,268,0,0,0,3029,2596
San Guillermo,Única,PN,CENTRO,2017m11,11,2017,NO COBRA,0,0,19,0,0,0,0,19,19
Sierra de las Quijadas,Única,PN,CENTRO,2017m11,11,2017,COBRA,68,711,148,13,292,244,69,1545,1477
Talampaya,Única,PN,CENTRO,2017m11,11,2017,COBRA,602,2424,68,0,114,2606,256,6070,5468
Chaco,Única,PN,NEA,2017m11,11,2017,NO COBRA,0,0,0,0,0,0,0,0,0
Colonia Benítez,Única,RNEd,NEA,2017m11,11,2017,NO COBRA,0,0,0,0,0,0,0,0,0
El Impenetrable,Única,PN,NEA,2017m11,11,2017,NO COBRA,0,0,0,0,0,0,0,0,0
Formosa,Única,RNat,NEA,2017m11,11,2017,NO COBRA,1,3,0,0,0,0,2,6,5
Iguazú,Única,PN,NEA,2017m11,11,2017,COBRA,54192,61970,6902,2530,0,18494,20222,164310,110118
Río Pilcomayo,Estero Poi,PN,NEA,2017m11,11,2017,NO COBRA,2,15,159,40,2,0,27,245,243
Río Pilcomayo,Laguna Blanca,PN,NEA,2017m11,11,2017,NO COBRA,31,92,393,305,0,7,262,1090,1059
Aconquija,Única,PN,NOA,2017m11,11,2017,NO COBRA,1,16,47,295,0,0,102,461,460
Baritú,Única,PN,NOA,2017m11,11,2017,NO COBRA,4,0,0,0,0,0,0,4,0
Calilegua,Única,PN,NOA,2017m11,11,2017,NO COBRA,149,251,152,399,742,0,394,2087,1938
Copo,Guayacán,PN,NOA,2017m11,11,2017,NO COBRA,0,0,0,0,0,0,0,0,0
Copo,Portada,PN,NOA,2017m11,11,2017,NO COBRA,0,17,0,0,0,0,45,62,62
El Rey,Única,PN,NOA,2017m11,11,2017,NO COBRA,25,52,77,0,0,0,160,314,289
Laguna de los Pozuelos,Única,MN,NOA,2017m11,11,2017,NO COBRA,79,21,1,0,0,0,1,102,23
Los Cardones,Recta del Tín Tín,PN,NOA,2017m11,11,2017,NO COBRA,200,6081,299,84,115,1534,93,8406,8206
Los Cardones,Valle Encantado,PN,NOA,2017m11,11,2017,NO COBRA,0,0,0,0,0,0,0,0,0
Nogalar de los Toldos,Única,RNac,NOA,2017m11,11,2017,NO COBRA,0,0,19,2,49,0,0,70,70
Pizarro,Única,RNac,NOA,2017m11,11,2017,NO COBRA,0,0,0,0,0,0,0,0,0
Bosques Petrificados,Única,PN,PATAGONIA,2017m11,11,2017,NO COBRA,158,234,9,16,0,37,12,466,308
Lago Puelo,Única,PN,PATAGONIA,2017m11,11,2017,COBRA,332,4056,1240,2947,206,1381,2061,12223,11891
Laguna Blanca,Única,PN,PATAGONIA,2017m11,11,2017,NO COBRA,0,0,0,0,0,0,0,0,0
Lanín,Hua Hum,PN,PATAGONIA,2017m11,11,2017,NO COBRA,0,0,0,0,0,0,0,0,0
Lanín,Lago Huechulaufquen,PN,PATAGONIA,2017m11,11,2017,COBRA,200,1349,165,0,239,1416,117,3486,3286
Lanín,Muelle Lago Lácar,PN,PATAGONIA,2017m11,11,2017,COBRA,107,854,618,0,738,597,38,2952,2845
Lanín,Quila Quina,PN,PATAGONIA,2017m11,11,2017,COBRA,47,866,219,0,119,613,7,1871,1824
Lanín,Ruka Choroy,PN,PATAGONIA,2017m11,11,2017,NO COBRA,0,0,0,0,0,0,0,0,0
Lanín,Volcán Lanín,PN,PATAGONIA,2017m11,11,2017,NO COBRA,0,0,0,0,0,0,0,0,0
Lanín,Área Tromen,PN,PATAGONIA,2017m11,11,2017,NO COBRA,0,0,0,0,0,0,0,0,0
Lanín,Ñorkinko,PN,PATAGONIA,2017m11,11,2017,NO COBRA,0,0,0,0,0,0,0,0,0
Lihué Calel,Única,PN,PATAGONIA,2017m11,11,2017,NO COBRA,13,135,221,15,502,0,14,900,887
Los Alerces,Portada Centro,PN,PATAGONIA,2017m11,11,2017,COBRA,0,0,0,0,0,0,0,0,0
Los Alerces,Portada Norte,PN,PATAGONIA,2017m11,11,2017,COBRA,757,1435,46,42,0,48,161,2489,1732
Los Alerces,Portada Sur,PN,PATAGONIA,2017m11,11,2017,COBRA,0,0,0,0,0,0,0,0,0
Los Alerces,Villa Futalaufquen,PN,PATAGONIA,2017m11,11,2017,NO COBRA,391,1123,35,25,0,29,104,1707,1316
Los Glaciares,El Chaltén,PN,PATAGONIA,2017m11,11,2017,NO COBRA,8757,4722,0,0,0,0,0,13479,4722
Los Glaciares,Puerto Bandera,PN,PATAGONIA,2017m11,11,2017,COBRA,7847,4586,24,4226,269,0,165,17117,9270
Los Glaciares,Puerto La Cruz,PN,PATAGONIA,2017m11,11,2017,NO COBRA,0,0,0,0,0,0,0,0,0
Los Glaciares,Puerto La Soledad,PN,PATAGONIA,2017m11,11,2017,COBRA,3150,381,0,206,43,0,0,3780,630
Los Glaciares,Puerto Lago Argentino,PN,PATAGONIA,2017m11,11,2017,COBRA,0,0,0,0,0,0,0,0,0
Los Glaciares,Río Mitre,PN,PATAGONIA,2017m11,11,2017,COBRA,58487,13050,2016,2046,1071,7228,2126,86024,27537
Monte León,Única,PN,PATAGONIA,2017m11,11,2017,NO COBRA,0,0,0,0,0,0,0,0,0
Nahuel Huapi,Lago Mascardi,PN,PATAGONIA,2017m11,11,2017,COBRA,1486,3616,261,3887,47,0,38,9335,7849
Nahuel Huapi,Puerto Pañuelo,PN,PATAGONIA,2017m11,11,2017,COBRA,5087,8913,417,6548,643,0,437,22045,16958
Nahuel Huapi,Quetrihué,PN,PATAGONIA,2017m11,11,2017,COBRA,846,2651,1008,1800,296,0,141,6742,5896
Nahuel Huapi,Río Limay,PN,PATAGONIA,2017m11,11,2017,COBRA,0,0,0,0,0,0,0,0,0
Patagonia,Única,PN,PATAGONIA,2017m11,11,2017,NO COBRA,0,0,0,0,0,0,0,0,0
Perito Moreno,Única,PN,PATAGONIA,2017m11,11,2017,NO COBRA,44,42,24,8,0,0,11,129,85
Tierra del Fuego,Ruta Nacional 3,PN,PATAGONIA,2017m11,11,2017,COBRA,15937,4711,5847,0,1031,1997,918,30441,14504
Tierra del Fuego,Tren del Fin del Mundo,PN,PATAGONIA,2017m11,11,2017,COBRA,11060,5486,222,0,108,2575,716,20167,9107
Ciervo de los Pantanos,Única,PN,CENTRO,2017m12,12,2017,NO COBRA,2,51,135,29,0,0,59,276,274
El Leoncito,Única,PN,CENTRO,2017m12,12,2017,NO COBRA,133,309,464,126,0,27,261,1320,1187
El Palmar,Única,PN,CENTRO,2017m12,12,2017,COBRA,146,4577,2151,759,276,1562,1848,11319,11173
Iberá,Cambyretá,PN,CENTRO,2017m12,12,2017,NO COBRA,41,68,0,0,0,30,12,151,110
Iberá,San Nicolás,PN,CENTRO,2017m12,12,2017,NO COBRA,0,0,0,0,0,0,0,0,0
Mburucuyá,Única,PN,CENTRO,2017m12,12,2017,NO COBRA,17,98,82,139,34,0,104,474,457
Pre Delta,Única,PN,CENTRO,2017m12,12,2017,NO COBRA,29,1342,1209,1580,0,42,1148,5350,5321
Quebrada del Condorito,Única,PN,CENTRO,2017m12,12,2017,NO COBRA,401,287,462,55,0,0,0,1205,804
San Guillermo,Única,PN,CENTRO,2017m12,12,2017,NO COBRA,0,0,0,0,0,0,0,0,0
Sierra de las Quijadas,Única,PN,CENTRO,2017m12,12,2017,COBRA,70,217,24,38,54,32,88,523,453
Talampaya,Única,PN,CENTRO,2017m12,12,2017,COBRA,651,826,24,0,114,566,118,2299,1648
Chaco,Única,PN,NEA,2017m12,12,2017,NO COBRA,0,0,0,0,0,0,0,0,0
Colonia Benítez,Única,RNEd,NEA,2017m12,12,2017,NO COBRA,4,3,7,0,102,0,0,116,112
El Impenetrable,Única,PN,NEA,2017m12,12,2017,NO COBRA,0,0,0,0,0,0,0,0,0
Formosa,Única,RNat,NEA,2017m12,12,2017,NO COBRA,0,2,0,0,0,0,0,2,2
Iguazú,Única,PN,NEA,2017m12,12,2017,COBRA,72882,27922,4807,3053,0,16283,17910,142857,69975
Río Pilcomayo,Estero Poi,PN,NEA,2017m12,12,2017,NO COBRA,7,10,58,47,0,0,1,123,116
Río Pilcomayo,Laguna Blanca,PN,NEA,2017m12,12,2017,NO COBRA,35,64,556,1972,0,4,1091,3722,3687
Aconquija,Única,PN,NOA,2017m12,12,2017,NO COBRA,2,9,13,75,0,0,11,110,108
Baritú,Única,PN,NOA,2017m12,12,2017,NO COBRA,0,0,0,0,0,0,0,0,0
Calilegua,Única,PN,NOA,2017m12,12,2017,NO COBRA,86,412,120,305,42,0,184,1149,1063
Copo,Guayacán,PN,NOA,2017m12,12,2017,NO COBRA,0,0,0,0,0,0,0,0,0
Copo,Portada,PN,NOA,2017m12,12,2017,NO COBRA,6,11,0,0,0,0,0,17,11
El Rey,Única,PN,NOA,2017m12,12,2017,NO COBRA,0,18,0,0,0,0,0,18,18
Laguna de los Pozuelos,Única,MN,NOA,2017m12,12,2017,NO COBRA,43,21,2,6,0,0,2,74,31
Los Cardones,Recta del Tín Tín,PN,NOA,2017m12,12,2017,NO COBRA,350,4709,148,121,0,1517,54,6899,6549
Los Cardones,Valle Encantado,PN,NOA,2017m12,12,2017,NO COBRA,0,0,0,0,0,0,0,0,0
Nogalar de los Toldos,Única,RNac,NOA,2017m12,12,2017,NO COBRA,0,16,9,37,0,0,0,62,62
Pizarro,Única,RNac,NOA,2017m12,12,2017,NO COBRA,0,0,0,0,0,0,0,0,0
Bosques Petrificados,Única,PN,PATAGONIA,2017m12,12,2017,NO COBRA,154,27,174,11,59,26,81,532,378
Lago Puelo,Única,PN,PATAGONIA,2017m12,12,2017,COBRA,545,6239,2554,12088,194,6133,3576,31329,30784
Laguna Blanca,Única,PN,PATAGONIA,2017m12,12,2017,NO COBRA,16,139,73,20,27,0,14,289,273
Lanín,Hua Hum,PN,PATAGONIA,2017m12,12,2017,NO COBRA,0,0,0,0,0,0,0,0,0
Lanín,Lago Huechulaufquen,PN,PATAGONIA,2017m12,12,2017,COBRA,354,1496,806,0,545,1603,569,5373,5019
Lanín,Muelle Lago Lácar,PN,PATAGONIA,2017m12,12,2017,COBRA,174,1373,468,0,341,555,121,3032,2858
Lanín,Quila Quina,PN,PATAGONIA,2017m12,12,2017,COBRA,111,1630,461,0,495,628,158,3483,3372
Lanín,Ruka Choroy,PN,PATAGONIA,2017m12,12,2017,NO COBRA,0,0,0,0,0,0,0,0,0
Lanín,Volcán Lanín,PN,PATAGONIA,2017m12,12,2017,NO COBRA,0,0,0,0,0,0,0,0,0
Lanín,Área Tromen,PN,PATAGONIA,2017m12,12,2017,NO COBRA,0,0,0,0,0,0,0,0,0
Lanín,Ñorkinko,PN,PATAGONIA,2017m12,12,2017,NO COBRA,0,0,0,0,0,0,0,0,0
Lihué Calel,Única,PN,PATAGONIA,2017m12,12,2017,NO COBRA,12,131,83,43,0,1,137,407,395
Los Alerces,Portada Centro,PN,PATAGONIA,2017m12,12,2017,COBRA,1388,2039,1547,8690,333,215,3198,17410,16022
Los Alerces,Portada Norte,PN,PATAGONIA,2017m12,12,2017,COBRA,987,1781,436,676,49,152,561,4642,3655
Los Alerces,Portada Sur,PN,PATAGONIA,2017m12,12,2017,COBRA,30,189,70,703,2,21,91,1106,1076
Los Alerces,Villa Futalaufquen,PN,PATAGONIA,2017m12,12,2017,NO COBRA,0,0,0,0,0,0,0,0,0
Los Glaciares,El Chaltén,PN,PATAGONIA,2017m12,12,2017,NO COBRA,14048,3714,0,0,0,0,0,17762,3714
Los Glaciares,Puerto Bandera,PN,PATAGONIA,2017m12,12,2017,COBRA,6627,1794,54,2007,287,0,530,11299,4672
Los Glaciares,Puerto La Cruz,PN,PATAGONIA,2017m12,12,2017,NO COBRA,0,0,0,0,0,0,0,0,0
Los Glaciares,Puerto La Soledad,PN,PATAGONIA,2017m12,12,2017,COBRA,3047,239,0,129,0,0,145,3560,513
Los Glaciares,Puerto Lago Argentino,PN,PATAGONIA,2017m12,12,2017,COBRA,0,0,0,0,0,0,0,0,0
Los Glaciares,Río Mitre,PN,PATAGONIA,2017m12,12,2017,COBRA,50923,10669,2794,2356,1992,5095,3843,77672,26749
Monte León,Única,PN,PATAGONIA,2017m12,12,2017,NO COBRA,146,165,161,114,0,0,203,789,643
Nahuel Huapi,Lago Mascardi,PN,PATAGONIA,2017m12,12,2017,COBRA,2381,3909,1613,1815,500,0,128,10346,7965
Nahuel Huapi,Puerto Pañuelo,PN,PATAGONIA,2017m12,12,2017,COBRA,6297,6026,909,5548,9036,0,858,28674,22377
Nahuel Huapi,Quetrihué,PN,PATAGONIA,2017m12,12,2017,COBRA,837,2482,1000,1270,519,0,0,6108,5271
Nahuel Huapi,Río Limay,PN,PATAGONIA,2017m12,12,2017,COBRA,0,0,4929,0,7748,0,0,12677,12677
Patagonia,Única,PN,PATAGONIA,2017m12,12,2017,NO COBRA,0,0,0,0,0,0,0,0,0
Perito Moreno,Única,PN,PATAGONIA,2017m12,12,2017,NO COBRA,171,45,16,12,0,0,17,261,90
Tierra del Fuego,Ruta Nacional 3,PN,PATAGONIA,2017m12,12,2017,COBRA,27458,5224,10158,0,1133,2236,1907,48116,20658
Tierra del Fuego,Tren del Fin del Mundo,PN,PATAGONIA,2017m12,12,2017,COBRA,12484,3847,324,0,144,1629,897,19325,6841
Ciervo de los Pantanos,Única,PN,CENTRO,2018m1,1,2018,NO COBRA,4,165,129,46,0,0,64,408,404
El Leoncito,Única,PN,CENTRO,2018m1,1,2018,NO COBRA,292,1786,1422,502,0,0,0,4002,3710
El Palmar,Única,PN,CENTRO,2018m1,1,2018,COBRA,103,11983,4759,1467,2102,3219,3960,27593,27490
Iberá,Cambyretá,PN,CENTRO,2018m1,1,2018,NO COBRA,100,459,141,0,0,0,42,742,642
Iberá,San Nicolás,PN,CENTRO,2018m1,1,2018,NO COBRA,0,0,0,0,0,0,0,0,0
Mburucuyá,Única,PN,CENTRO,2018m1,1,2018,NO COBRA,10,244,145,159,0,0,346,904,894
Pre Delta,Única,PN,CENTRO,2018m1,1,2018,NO COBRA,48,1507,2329,2673,16,90,1177,7840,7792
Quebrada del Condorito,Única,PN,CENTRO,2018m1,1,2018,NO COBRA,403,1823,851,84,0,0,0,3161,2758
San Guillermo,Única,PN,CENTRO,2018m1,1,2018,NO COBRA,0,0,0,0,0,0,0,0,0
Sierra de las Quijadas,Única,PN,CENTRO,2018m1,1,2018,COBRA,132,2430,172,14,126,260,335,3469,3337
Talampaya,Única,PN,CENTRO,2018m1,1,2018,COBRA,592,2010,63,0,197,385,497,3744,3152
Chaco,Única,PN,NEA,2018m1,1,2018,NO COBRA,0,0,0,0,0,0,0,0,0
Colonia Benítez,Única,RNEd,NEA,2018m1,1,2018,NO COBRA,1,19,6,0,6,2,2,36,35
El Impenetrable,Única,PN,NEA,2018m1,1,2018,NO COBRA,0,64,14,0,0,0,0,78,78
Formosa,Única,RNat,NEA,2018m1,1,2018,NO COBRA,7,14,0,2,0,0,2,25,18
Iguazú,Única,PN,NEA,2018m1,1,2018,COBRA,102553,94923,19678,3439,0,23663,47863,292119,189566
Río Pilcomayo,Estero Poi,PN,NEA,2018m1,1,2018,NO COBRA,8,22,64,32,0,0,11,137,129
Río Pilcomayo,Laguna Blanca,PN,NEA,2018m1,1,2018,NO COBRA,92,161,198,1942,0,0,12,2405,2313
Aconquija,Única,PN,NOA,2018m1,1,2018,NO COBRA,0,0,4,20,0,0,4,28,28
Baritú,Única,PN,NOA,2018m1,1,2018,NO COBRA,0,27,0,0,0,0,0,27,27
Calilegua,Única,PN,NOA,2018m1,1,2018,NO COBRA,65,611,175,661,0,0,562,2074,2009
Copo,Guayacán,PN,NOA,2018m1,1,2018,NO COBRA,0,0,0,0,0,0,0,0,0
Copo,Portada,PN,NOA,2018m1,1,2018,NO COBRA,8,4,0,0,0,0,0,12,4
El Rey,Única,PN,NOA,2018m1,1,2018,NO COBRA,10,23,61,0,0,0,13,107,97
Laguna de los Pozuelos,Única,MN,NOA,2018m1,1,2018,NO COBRA,47,84,34,21,0,2,12,200,153
Los Cardones,Recta del Tín Tín,PN,NOA,2018m1,1,2018,NO COBRA,381,5731,572,47,0,5771,58,12560,12179
Los Cardones,Valle Encantado,PN,NOA,2018m1,1,2018,NO COBRA,0,0,0,0,0,0,0,0,0
Nogalar de los Toldos,Única,RNac,NOA,2018m1,1,2018,NO COBRA,61,22,41,68,0,5,81,278,217
Pizarro,Única,RNac,NOA,2018m1,1,2018,NO COBRA,0,0,0,0,0,0,0,0,0
Bosques Petrificados,Única,PN,PATAGONIA,2018m1,1,2018,NO COBRA,155,751,176,41,165,94,340,1722,1567
Lago Puelo,Única,PN,PATAGONIA,2018m1,1,2018,COBRA,1644,50690,22644,22705,4729,8758,12113,123283,121639
Laguna Blanca,Única,PN,PATAGONIA,2018m1,1,2018,NO COBRA,36,204,65,5,0,0,68,378,342
Lanín,Hua Hum,PN,PATAGONIA,2018m1,1,2018,NO COBRA,0,0,0,0,0,0,0,0,0
Lanín,Lago Huechulaufquen,PN,PATAGONIA,2018m1,1,2018,COBRA,488,9753,4274,0,4432,4966,1133,25046,24558
Lanín,Muelle Lago Lácar,PN,PATAGONIA,2018m1,1,2018,COBRA,318,6980,1192,0,860,1583,586,11519,11201
Lanín,Quila Quina,PN,PATAGONIA,2018m1,1,2018,COBRA,493,8130,3034,0,3991,1260,2688,19596,19103
Lanín,Ruka Choroy,PN,PATAGONIA,2018m1,1,2018,NO COBRA,0,0,0,0,0,0,0,0,0
Lanín,Volcán Lanín,PN,PATAGONIA,2018m1,1,2018,NO COBRA,0,0,0,0,0,0,0,0,0
Lanín,Área Tromen,PN,PATAGONIA,2018m1,1,2018,NO COBRA,0,0,0,0,0,0,0,0,0
Lanín,Ñorkinko,PN,PATAGONIA,2018m1,1,2018,NO COBRA,0,0,0,0,0,0,0,0,0
Lihué Calel,Única,PN,PATAGONIA,2018m1,1,2018,NO COBRA,66,156,25,18,1,3,48,317,251
Los Alerces,Portada Centro,PN,PATAGONIA,2018m1,1,2018,COBRA,626,5033,3293,1184,1454,1506,1260,14356,13730
Los Alerces,Portada Norte,PN,PATAGONIA,2018m1,1,2018,COBRA,1459,6600,2837,34295,2151,1543,7237,56122,54663
Los Alerces,Portada Sur,PN,PATAGONIA,2018m1,1,2018,COBRA,144,5084,1958,6565,1610,1446,1875,18682,18538
Los Alerces,Villa Futalaufquen,PN,PATAGONIA,2018m1,1,2018,NO COBRA,0,0,0,0,0,0,0,0,0
Los Glaciares,El Chaltén,PN,PATAGONIA,2018m1,1,2018,NO COBRA,12182,7016,0,0,0,0,0,19198,7016
Los Glaciares,Puerto Bandera,PN,PATAGONIA,2018m1,1,2018,COBRA,10980,8924,76,4104,661,0,602,25347,14367
Los Glaciares,Puerto La Cruz,PN,PATAGONIA,2018m1,1,2018,NO COBRA,0,0,0,0,0,0,0,0,0
Los Glaciares,Puerto La Soledad,PN,PATAGONIA,2018m1,1,2018,COBRA,3576,901,0,539,0,0,178,5194,1618
Los Glaciares,Puerto Lago Argentino,PN,PATAGONIA,2018m1,1,2018,COBRA,0,0,0,0,0,0,0,0,0
Los Glaciares,Río Mitre,PN,PATAGONIA,2018m1,1,2018,COBRA,67017,28019,7662,6742,4633,11446,6246,131765,64748
Monte León,Única,PN,PATAGONIA,2018m1,1,2018,NO COBRA,524,860,498,687,0,0,791,3360,2836
Nahuel Huapi,Lago Mascardi,PN,PATAGONIA,2018m1,1,2018,COBRA,3802,16740,932,10049,4108,0,5534,41165,37363
Nahuel Huapi,Puerto Pañuelo,PN,PATAGONIA,2018m1,1,2018,COBRA,6045,15251,3423,10688,4885,0,4413,44705,38660
Nahuel Huapi,Quetrihué,PN,PATAGONIA,2018m1,1,2018,COBRA,472,8529,5572,3618,2934,0,313,21438,20966
Nahuel Huapi,Río Limay,PN,PATAGONIA,2018m1,1,2018,COBRA,0,0,318,0,1803,0,0,2121,2121
Patagonia,Única,PN,PATAGONIA,2018m1,1,2018,NO COBRA,0,0,0,0,0,0,0,0,0
Perito Moreno,Única,PN,PATAGONIA,2018m1,1,2018,NO COBRA,74,196,26,35,0,0,59,390,316
Tierra del Fuego,Ruta Nacional 3,PN,PATAGONIA,2018m1,1,2018,COBRA,41549,13046,10848,0,4100,4867,5907,80317,38768
Tierra del Fuego,Tren del Fin del Mundo,PN,PATAGONIA,2018m1,1,2018,COBRA,14447,8200,678,0,573,3218,2670,29786,15339
Ciervo de los Pantanos,Única,PN,CENTRO,2018m2,2,2018,NO COBRA,1,223,823,102,9,4,306,1468,1467
El Leoncito,Única,PN,CENTRO,2018m2,2,2018,NO COBRA,36,166,166,19,0,0,0,387,351
El Palmar,Única,PN,CENTRO,2018m2,2,2018,COBRA,72,10752,3581,414,1160,2652,4865,23496,23424
Iberá,Cambyretá,PN,CENTRO,2018m2,2,2018,NO COBRA,91,440,18,92,0,3,71,715,624
Iberá,San Nicolás,PN,CENTRO,2018m2,2,2018,NO COBRA,0,0,0,0,0,0,0,0,0
Mburucuyá,Única,PN,CENTRO,2018m2,2,2018,NO COBRA,39,707,403,211,0,4,392,1756,1717
Pre Delta,Única,PN,CENTRO,2018m2,2,2018,NO COBRA,64,2039,3186,3180,4,118,1739,10330,10266
Quebrada del Condorito,Única,PN,CENTRO,2018m2,2,2018,NO COBRA,215,1585,1246,167,0,0,0,3213,2998
San Guillermo,Única,PN,CENTRO,2018m2,2,2018,NO COBRA,0,0,0,0,0,0,0,0,0
Sierra de las Quijadas,Única,PN,CENTRO,2018m2,2,2018,COBRA,49,2155,318,3,344,245,413,3527,3478
Talampaya,Única,PN,CENTRO,2018m2,2,2018,COBRA,478,2511,129,0,107,542,432,4199,3721
Chaco,Única,PN,NEA,2018m2,2,2018,NO COBRA,0,0,0,0,0,0,0,0,0
Colonia Benítez,Única,RNEd,NEA,2018m2,2,2018,NO COBRA,0,0,0,0,0,0,0,0,0
El Impenetrable,Única,PN,NEA,2018m2,2,2018,NO COBRA,0,26,2,0,0,0,0,28,28
Formosa,Única,RNat,NEA,2018m2,2,2018,NO COBRA,0,0,0,0,0,0,0,0,0
Iguazú,Única,PN,NEA,2018m2,2,2018,COBRA,81537,100108,8463,3314,0,22596,27507,243525,161988
Río Pilcomayo,Estero Poi,PN,NEA,2018m2,2,2018,NO COBRA,10,16,54,66,0,0,26,172,162
Río Pilcomayo,Laguna Blanca,PN,NEA,2018m2,2,2018,NO COBRA,21,152,463,727,0,0,676,2039,2018
Aconquija,Única,PN,NOA,2018m2,2,2018,NO COBRA,0,3,0,0,0,0,0,3,3
Baritú,Única,PN,NOA,2018m2,2,2018,NO COBRA,0,0,0,0,0,0,0,0,0
Calilegua,Única,PN,NOA,2018m2,2,2018,NO COBRA,114,551,161,475,0,0,346,1647,1533
Copo,Guayacán,PN,NOA,2018m2,2,2018,NO COBRA,0,0,0,0,0,0,0,0,0
Copo,Portada,PN,NOA,2018m2,2,2018,NO COBRA,12,8,0,0,0,0,0,20,8
El Rey,Única,PN,NOA,2018m2,2,2018,NO COBRA,0,0,0,0,0,0,0,0,0
Laguna de los Pozuelos,Única,MN,NOA,2018m2,2,2018,NO COBRA,31,14,13,8,1,0,1,68,37
Los Cardones,Recta del Tín Tín,PN,NOA,2018m2,2,2018,NO COBRA,191,499,367,23,0,314,24,1418,1227
Los Cardones,Valle Encantado,PN,NOA,2018m2,2,2018,NO COBRA,0,0,0,0,0,0,0,0,0
Nogalar de los Toldos,Única,RNac,NOA,2018m2,2,2018,NO COBRA,0,0,0,2,0,0,47,49,49
Pizarro,Única,RNac,NOA,2018m2,2,2018,NO COBRA,0,0,0,0,0,0,0,0,0
Bosques Petrificados,Única,PN,PATAGONIA,2018m2,2,2018,NO COBRA,192,377,63,12,96,38,139,917,725
Lago Puelo,Única,PN,PATAGONIA,2018m2,2,2018,COBRA,1043,25868,11698,32191,1765,0,2836,75401,74358
Laguna Blanca,Única,PN,PATAGONIA,2018m2,2,2018,NO COBRA,16,128,92,13,35,0,15,299,283
Lanín,Hua Hum,PN,PATAGONIA,2018m2,2,2018,NO COBRA,0,0,0,0,0,0,0,0,0
Lanín,Lago Huechulaufquen,PN,PATAGONIA,2018m2,2,2018,COBRA,332,5652,2133,0,1620,3841,1089,14667,14335
Lanín,Muelle Lago Lácar,PN,PATAGONIA,2018m2,2,2018,COBRA,795,3541,1643,0,500,1326,706,8511,7716
Lanín,Quila Quina,PN,PATAGONIA,2018m2,2,2018,COBRA,752,6303,1579,0,1885,1016,1035,12570,11818
Lanín,Ruka Choroy,PN,PATAGONIA,2018m2,2,2018,NO COBRA,0,0,0,0,0,0,0,0,0
Lanín,Volcán Lanín,PN,PATAGONIA,2018m2,2,2018,NO COBRA,0,0,0,0,0,0,0,0,0
Lanín,Área Tromen,PN,PATAGONIA,2018m2,2,2018,NO COBRA,0,0,0,0,0,0,0,0,0
Lanín,Ñorkinko,PN,PATAGONIA,2018m2,2,2018,NO COBRA,0,0,0,0,0,0,0,0,0
Lihué Calel,Única,PN,PATAGONIA,2018m2,2,2018,NO COBRA,24,237,73,71,0,0,82,487,463
Los Alerces,Portada Centro,PN,PATAGONIA,2018m2,2,2018,COBRA,992,3262,3067,2063,455,1191,1658,12688,11696
Los Alerces,Portada Norte,PN,PATAGONIA,2018m2,2,2018,COBRA,814,4372,2941,17708,831,1234,3907,31807,30993
Los Alerces,Portada Sur,PN,PATAGONIA,2018m2,2,2018,COBRA,127,2392,1855,6107,975,948,1922,14326,14199
Los Alerces,Villa Futalaufquen,PN,PATAGONIA,2018m2,2,2018,NO COBRA,0,0,0,0,0,0,0,0,0
Los Glaciares,El Chaltén,PN,PATAGONIA,2018m2,2,2018,NO COBRA,11014,7222,0,0,0,0,0,18236,7222
Los Glaciares,Puerto Bandera,PN,PATAGONIA,2018m2,2,2018,COBRA,6174,3944,59,2721,383,0,581,13862,7688
Los Glaciares,Puerto La Cruz,PN,PATAGONIA,2018m2,2,2018,NO COBRA,0,0,0,0,0,0,0,0,0
Los Glaciares,Puerto La Soledad,PN,PATAGONIA,2018m2,2,2018,COBRA,6519,1439,0,921,99,0,144,9122,2603
Los Glaciares,Puerto Lago Argentino,PN,PATAGONIA,2018m2,2,2018,COBRA,0,0,0,0,0,0,0,0,0
Los Glaciares,Río Mitre,PN,PATAGONIA,2018m2,2,2018,COBRA,46048,13397,10662,7860,2218,6811,6666,93662,47614
Monte León,Única,PN,PATAGONIA,2018m2,2,2018,NO COBRA,263,427,568,604,3,0,1132,2997,2734
Nahuel Huapi,Lago Mascardi,PN,PATAGONIA,2018m2,2,2018,COBRA,2971,10010,397,8670,2468,0,510,25026,22055
Nahuel Huapi,Puerto Pañuelo,PN,PATAGONIA,2018m2,2,2018,COBRA,3619,14573,564,9035,2867,0,3816,34474,30855
Nahuel Huapi,Quetrihué,PN,PATAGONIA,2018m2,2,2018,COBRA,920,4676,1551,2433,861,0,1394,11835,10915
Nahuel Huapi,Río Limay,PN,PATAGONIA,2018m2,2,2018,COBRA,0,0,0,0,0,0,0,0,0
Patagonia,Única,PN,PATAGONIA,2018m2,2,2018,NO COBRA,0,0,0,0,0,0,0,0,0
Perito Moreno,Única,PN,PATAGONIA,2018m2,2,2018,NO COBRA,174,107,16,23,0,0,25,345,171
Tierra del Fuego,Ruta Nacional 3,PN,PATAGONIA,2018m2,2,2018,COBRA,19901,8069,9420,0,2372,3282,3461,46505,26604
Tierra del Fuego,Tren del Fin del Mundo,PN,PATAGONIA,2018m2,2,2018,COBRA,11354,8248,350,0,499,3972,1324,25747,14393
Ciervo de los Pantanos,Única,PN,CENTRO,2018m3,3,2018,NO COBRA,13,194,916,120,0,26,458,1727,1714
El Leoncito,Única,PN,CENTRO,2018m3,3,2018,NO COBRA,67,520,581,69,0,0,0,1237,1170
El Palmar,Única,PN,CENTRO,2018m3,3,2018,COBRA,91,6768,2962,286,505,2149,2829,15590,15499
Iberá,Cambyretá,PN,CENTRO,2018m3,3,2018,NO COBRA,66,174,22,42,13,87,78,482,416
Iberá,San Nicolás,PN,CENTRO,2018m3,3,2018,NO COBRA,0,0,0,0,0,0,0,0,0
Mburucuyá,Única,PN,CENTRO,2018m3,3,2018,NO COBRA,13,102,144,35,9,2,69,374,361
Pre Delta,Única,PN,CENTRO,2018m3,3,2018,NO COBRA,55,1878,2217,3647,136,363,2343,10639,10584
Quebrada del Condorito,Única,PN,CENTRO,2018m3,3,2018,NO COBRA,567,1987,2378,315,0,0,0,5247,4680
San Guillermo,Única,PN,CENTRO,2018m3,3,2018,NO COBRA,0,0,0,0,0,0,0,0,0
Sierra de las Quijadas,Única,PN,CENTRO,2018m3,3,2018,COBRA,89,2263,394,3,366,600,245,3960,3871
Talampaya,Única,PN,CENTRO,2018m3,3,2018,COBRA,748,5693,220,0,188,1957,503,9309,8561
Chaco,Única,PN,NEA,2018m3,3,2018,NO COBRA,0,0,0,0,0,0,0,0,0
Colonia Benítez,Única,RNEd,NEA,2018m3,3,2018,NO COBRA,3,33,13,0,0,0,0,49,46
El Impenetrable,Única,PN,NEA,2018m3,3,2018,NO COBRA,0,0,20,0,0,0,0,20,20
Formosa,Única,RNat,NEA,2018m3,3,2018,NO COBRA,0,2,0,0,0,0,0,2,2
Iguazú,Única,PN,NEA,2018m3,3,2018,COBRA,92651,76817,5652,1987,0,19499,15829,212435,119784
Río Pilcomayo,Estero Poi,PN,NEA,2018m3,3,2018,NO COBRA,10,26,36,30,0,0,23,125,115
Río Pilcomayo,Laguna Blanca,PN,NEA,2018m3,3,2018,NO COBRA,4,80,118,240,0,0,147,589,585
Aconquija,Única,PN,NOA,2018m3,3,2018,NO COBRA,1,6,14,25,71,0,14,131,130
Baritú,Única,PN,NOA,2018m3,3,2018,NO COBRA,12,24,0,1,0,0,11,48,36
Calilegua,Única,PN,NOA,2018m3,3,2018,NO COBRA,180,379,104,579,0,0,202,1444,1264
Copo,Guayacán,PN,NOA,2018m3,3,2018,NO COBRA,0,0,0,0,0,0,0,0,0
Copo,Portada,PN,NOA,2018m3,3,2018,NO COBRA,0,0,0,0,0,0,0,0,0
El Rey,Única,PN,NOA,2018m3,3,2018,NO COBRA,0,4,19,6,0,0,11,40,40
Laguna de los Pozuelos,Única,MN,NOA,2018m3,3,2018,NO COBRA,42,60,80,11,2,4,11,210,168
Los Cardones,Recta del Tín Tín,PN,NOA,2018m3,3,2018,NO COBRA,378,6137,346,377,0,4627,156,12021,11643
Los Cardones,Valle Encantado,PN,NOA,2018m3,3,2018,NO COBRA,0,0,0,0,0,0,0,0,0
Nogalar de los Toldos,Única,RNac,NOA,2018m3,3,2018,NO COBRA,29,56,42,62,0,0,41,230,201
Pizarro,Única,RNac,NOA,2018m3,3,2018,NO COBRA,0,0,0,0,0,0,0,0,0
Bosques Petrificados,Única,PN,PATAGONIA,2018m3,3,2018,NO COBRA,174,180,81,23,24,113,50,645,471
Lago Puelo,Única,PN,PATAGONIA,2018m3,3,2018,COBRA,346,11107,2694,14182,844,4311,1711,35195,34849
Laguna Blanca,Única,PN,PATAGONIA,2018m3,3,2018,NO COBRA,0,239,0,0,0,0,80,319,319
Lanín,Hua Hum,PN,PATAGONIA,2018m3,3,2018,NO COBRA,0,0,0,0,0,0,0,0,0
Lanín,Lago Huechulaufquen,PN,PATAGONIA,2018m3,3,2018,COBRA,547,3735,803,0,439,1926,129,7579,7032
Lanín,Muelle Lago Lácar,PN,PATAGONIA,2018m3,3,2018,COBRA,217,2435,347,0,150,932,81,4162,3945
Lanín,Quila Quina,PN,PATAGONIA,2018m3,3,2018,COBRA,133,3010,269,0,372,547,86,4417,4284
Lanín,Ruka Choroy,PN,PATAGONIA,2018m3,3,2018,NO COBRA,0,0,0,0,0,0,0,0,0
Lanín,Volcán Lanín,PN,PATAGONIA,2018m3,3,2018,NO COBRA,0,0,0,0,0,0,0,0,0
Lanín,Área Tromen,PN,PATAGONIA,2018m3,3,2018,NO COBRA,0,0,0,0,0,0,0,0,0
Lanín,Ñorkinko,PN,PATAGONIA,2018m3,3,2018,NO COBRA,0,0,0,0,0,0,0,0,0
Lihué Calel,Única,PN,PATAGONIA,2018m3,3,2018,NO COBRA,9,108,62,58,0,2,64,303,294
Los Alerces,Portada Centro,PN,PATAGONIA,2018m3,3,2018,COBRA,515,1972,1575,6979,240,1607,1544,14432,13917
Los Alerces,Portada Norte,PN,PATAGONIA,2018m3,3,2018,COBRA,447,1410,502,610,103,449,166,3687,3240
Los Alerces,Portada Sur,PN,PATAGONIA,2018m3,3,2018,COBRA,75,1077,974,6133,260,1735,955,11209,11134
Los Alerces,Villa Futalaufquen,PN,PATAGONIA,2018m3,3,2018,NO COBRA,0,0,0,0,0,0,0,0,0
Los Glaciares,El Chaltén,PN,PATAGONIA,2018m3,3,2018,NO COBRA,9618,4359,0,0,0,0,0,13977,4359
Los Glaciares,Puerto Bandera,PN,PATAGONIA,2018m3,3,2018,COBRA,8036,3589,67,4450,671,0,201,17014,8978
Los Glaciares,Puerto La Cruz,PN,PATAGONIA,2018m3,3,2018,NO COBRA,0,0,0,0,0,0,0,0,0
Los Glaciares,Puerto La Soledad,PN,PATAGONIA,2018m3,3,2018,COBRA,4881,1769,360,863,0,0,0,7873,2992
Los Glaciares,Puerto Lago Argentino,PN,PATAGONIA,2018m3,3,2018,COBRA,0,0,0,0,0,0,0,0,0
Los Glaciares,Río Mitre,PN,PATAGONIA,2018m3,3,2018,COBRA,41551,18602,2988,11939,2936,8873,3469,90358,48807
Monte León,Única,PN,PATAGONIA,2018m3,3,2018,NO COBRA,181,405,68,227,0,0,181,1062,881
Nahuel Huapi,Lago Mascardi,PN,PATAGONIA,2018m3,3,2018,COBRA,2293,8553,109,5814,1244,0,188,18201,15908
Nahuel Huapi,Puerto Pañuelo,PN,PATAGONIA,2018m3,3,2018,COBRA,3810,16017,610,5755,1394,0,563,28149,24339
Nahuel Huapi,Quetrihué,PN,PATAGONIA,2018m3,3,2018,COBRA,360,1978,1108,626,1185,0,321,5578,5218
Nahuel Huapi,Río Limay,PN,PATAGONIA,2018m3,3,2018,COBRA,0,0,0,0,0,0,0,0,0
Patagonia,Única,PN,PATAGONIA,2018m3,3,2018,NO COBRA,0,0,0,0,0,0,0,0,0
Perito Moreno,Única,PN,PATAGONIA,2018m3,3,2018,NO COBRA,115,46,11,4,0,0,11,187,72
Tierra del Fuego,Ruta Nacional 3,PN,PATAGONIA,2018m3,3,2018,COBRA,12465,6981,8837,0,1172,4483,1907,35845,23380
Tierra del Fuego,Tren del Fin del Mundo,PN,PATAGONIA,2018m3,3,2018,COBRA,6051,6767,242,0,360,4629,885,18934,12883
Ciervo de los Pantanos,Única,PN,CENTRO,2018m4,4,2018,NO COBRA,0,68,265,181,0,2,322,838,838
El Leoncito,Única,PN,CENTRO,2018m4,4,2018,NO COBRA,176,1064,822,113,0,0,0,2175,1999
El Palmar,Única,PN,CENTRO,2018m4,4,2018,COBRA,174,9547,1507,444,758,2813,1878,17121,16947
Iberá,Cambyretá,PN,CENTRO,2018m4,4,2018,NO COBRA,67,148,58,33,0,25,47,378,311
Iberá,San Nicolás,PN,CENTRO,2018m4,4,2018,NO COBRA,42,245,150,118,0,0,90,645,603
Mburucuyá,Única,PN,CENTRO,2018m4,4,2018,NO COBRA,4,282,84,90,0,4,98,562,558
Pre Delta,Única,PN,CENTRO,2018m4,4,2018,NO COBRA,67,1901,1636,1500,0,16,1543,6663,6596
Quebrada del Condorito,Única,PN,CENTRO,2018m4,4,2018,NO COBRA,270,653,1732,291,0,0,0,2946,2676
San Guillermo,Única,PN,CENTRO,2018m4,4,2018,NO COBRA,0,4,0,0,0,0,0,4,4
Sierra de las Quijadas,Única,PN,CENTRO,2018m4,4,2018,COBRA,100,1782,626,7,213,802,169,3699,3599
Talampaya,Única,PN,CENTRO,2018m4,4,2018,COBRA,686,4739,182,0,191,2488,411,8697,8011
Chaco,Única,PN,NEA,2018m4,4,2018,NO COBRA,0,16,157,139,0,1,123,436,436
Colonia Benítez,Única,RNEd,NEA,2018m4,4,2018,NO COBRA,0,3,0,1,275,0,0,279,279
El Impenetrable,Única,PN,NEA,2018m4,4,2018,NO COBRA,0,50,0,0,0,0,0,50,50
Formosa,Única,RNat,NEA,2018m4,4,2018,NO COBRA,0,0,0,0,0,0,0,0,0
Iguazú,Única,PN,NEA,2018m4,4,2018,COBRA,45604,40927,2913,2171,0,19618,17771,129004,83400
Río Pilcomayo,Estero Poi,PN,NEA,2018m4,4,2018,NO COBRA,11,66,46,21,14,0,31,189,178
Río Pilcomayo,Laguna Blanca,PN,NEA,2018m4,4,2018,NO COBRA,37,130,345,340,0,0,251,1103,1066
Aconquija,Única,PN,NOA,2018m4,4,2018,NO COBRA,0,7,2,2,11,0,2,24,24
Baritú,Única,PN,NOA,2018m4,4,2018,NO COBRA,4,2,4,2,0,0,0,12,8
Calilegua,Única,PN,NOA,2018m4,4,2018,NO COBRA,231,392,272,402,0,0,365,1662,1431
Copo,Guayacán,PN,NOA,2018m4,4,2018,NO COBRA,0,0,0,0,0,0,0,0,0
Copo,Portada,PN,NOA,2018m4,4,2018,NO COBRA,0,0,0,0,0,0,0,0,0
El Rey,Única,PN,NOA,2018m4,4,2018,NO COBRA,0,34,44,17,0,0,43,138,138
Laguna de los Pozuelos,Única,MN,NOA,2018m4,4,2018,NO COBRA,95,66,19,11,0,0,8,199,104
Los Cardones,Recta del Tín Tín,PN,NOA,2018m4,4,2018,NO COBRA,565,5967,276,157,183,3764,86,10998,10433
Los Cardones,Valle Encantado,PN,NOA,2018m4,4,2018,NO COBRA,0,0,0,0,0,0,0,0,0
Nogalar de los Toldos,Única,RNac,NOA,2018m4,4,2018,NO COBRA,16,2,31,54,0,0,27,130,114
Pizarro,Única,RNac,NOA,2018m4,4,2018,NO COBRA,0,0,0,0,0,0,0,0,0
Bosques Petrificados,Única,PN,PATAGONIA,2018m4,4,2018,NO COBRA,21,63,26,8,3,13,16,150,129
Lago Puelo,Única,PN,PATAGONIA,2018m4,4,2018,COBRA,239,5485,1552,13398,87,2124,435,23320,23081
Laguna Blanca,Única,PN,PATAGONIA,2018m4,4,2018,NO COBRA,12,406,435,404,0,3,208,1468,1456
Lanín,Hua Hum,PN,PATAGONIA,2018m4,4,2018,NO COBRA,0,0,0,0,0,0,0,0,0
Lanín,Lago Huechulaufquen,PN,PATAGONIA,2018m4,4,2018,COBRA,0,906,474,0,252,784,340,2756,2756
Lanín,Muelle Lago Lácar,PN,PATAGONIA,2018m4,4,2018,COBRA,110,1345,650,0,97,619,123,2944,2834
Lanín,Quila Quina,PN,PATAGONIA,2018m4,4,2018,COBRA,18,1351,767,0,261,476,108,2981,2963
Lanín,Ruka Choroy,PN,PATAGONIA,2018m4,4,2018,NO COBRA,0,0,0,0,0,0,0,0,0
Lanín,Volcán Lanín,PN,PATAGONIA,2018m4,4,2018,NO COBRA,0,0,0,0,0,0,0,0,0
Lanín,Área Tromen,PN,PATAGONIA,2018m4,4,2018,NO COBRA,0,0,0,0,0,0,0,0,0
Lanín,Ñorkinko,PN,PATAGONIA,2018m4,4,2018,NO COBRA,0,0,0,0,0,0,0,0,0
Lihué Calel,Única,PN,PATAGONIA,2018m4,4,2018,NO COBRA,4,135,193,30,3,23,85,473,469
Los Alerces,Portada Centro,PN,PATAGONIA,2018m4,4,2018,COBRA,182,745,193,256,14,121,109,1620,1438
Los Alerces,Portada Norte,PN,PATAGONIA,2018m4,4,2018,COBRA,13,132,331,148,1,60,90,775,762
Los Alerces,Portada Sur,PN,PATAGONIA,2018m4,4,2018,COBRA,15,37,69,1355,147,155,162,1940,1925
Los Alerces,Villa Futalaufquen,PN,PATAGONIA,2018m4,4,2018,NO COBRA,0,0,0,0,0,0,0,0,0
Los Glaciares,El Chaltén,PN,PATAGONIA,2018m4,4,2018,NO COBRA,5200,4442,0,0,0,0,0,9642,4442
Los Glaciares,Puerto Bandera,PN,PATAGONIA,2018m4,4,2018,COBRA,2256,4157,119,2778,242,0,174,9726,7470
Los Glaciares,Puerto La Cruz,PN,PATAGONIA,2018m4,4,2018,NO COBRA,0,0,0,0,0,0,0,0,0
Los Glaciares,Puerto La Soledad,PN,PATAGONIA,2018m4,4,2018,COBRA,1889,1229,487,850,488,0,163,5106,3217
Los Glaciares,Puerto Lago Argentino,PN,PATAGONIA,2018m4,4,2018,COBRA,0,0,0,0,0,0,0,0,0
Los Glaciares,Río Mitre,PN,PATAGONIA,2018m4,4,2018,COBRA,19377,14032,1787,2800,1509,6481,1882,47868,28491
Monte León,Única,PN,PATAGONIA,2018m4,4,2018,NO COBRA,93,67,31,26,0,0,45,262,169
Nahuel Huapi,Lago Mascardi,PN,PATAGONIA,2018m4,4,2018,COBRA,1876,6266,106,3963,554,0,54,12819,10943
Nahuel Huapi,Puerto Pañuelo,PN,PATAGONIA,2018m4,4,2018,COBRA,2227,7719,630,5601,780,0,385,17342,15115
Nahuel Huapi,Quetrihué,PN,PATAGONIA,2018m4,4,2018,COBRA,470,1316,1213,1181,595,0,1460,6235,5765
Nahuel Huapi,Río Limay,PN,PATAGONIA,2018m4,4,2018,COBRA,0,0,0,0,0,0,0,0,0
Patagonia,Única,PN,PATAGONIA,2018m4,4,2018,NO COBRA,0,0,0,0,0,0,0,0,0
Perito Moreno,Única,PN,PATAGONIA,2018m4,4,2018,NO COBRA,33,19,12,8,0,0,2,74,41
Tierra del Fuego,Ruta Nacional 3,PN,PATAGONIA,2018m4,4,2018,COBRA,5143,4419,3810,0,976,1765,2548,18661,13518
Tierra del Fuego,Tren del Fin del Mundo,PN,PATAGONIA,2018m4,4,2018,COBRA,1990,4164,246,0,208,2677,442,9727,7737
Ciervo de los Pantanos,Única,PN,CENTRO,2018m5,5,2018,NO COBRA,0,42,702,62,145,2,411,1364,1364
El Leoncito,Única,PN,CENTRO,2018m5,5,2018,NO COBRA,185,729,409,92,0,0,0,1415,1230
El Palmar,Única,PN,CENTRO,2018m5,5,2018,COBRA,67,3117,1048,920,105,2280,366,7903,7836
Iberá,Cambyretá,PN,CENTRO,2018m5,5,2018,NO COBRA,58,75,22,76,30,115,27,403,345
Iberá,San Nicolás,PN,CENTRO,2018m5,5,2018,NO COBRA,28,104,42,18,6,3,13,214,186
Mburucuyá,Única,PN,CENTRO,2018m5,5,2018,NO COBRA,2,193,224,261,27,12,211,930,928
Pre Delta,Única,PN,CENTRO,2018m5,5,2018,NO COBRA,27,974,3243,3115,23,68,994,8444,8417
Quebrada del Condorito,Única,PN,CENTRO,2018m5,5,2018,NO COBRA,196,429,1396,265,0,0,0,2286,2090
San Guillermo,Única,PN,CENTRO,2018m5,5,2018,NO COBRA,1,9,0,0,0,0,2,12,11
Sierra de las Quijadas,Única,PN,CENTRO,2018m5,5,2018,COBRA,42,755,596,2,185,668,132,2380,2338
Talampaya,Única,PN,CENTRO,2018m5,5,2018,COBRA,412,2989,129,0,170,1856,261,5817,5405
Chaco,Única,PN,NEA,2018m5,5,2018,NO COBRA,16,95,384,500,104,9,500,1608,1592
Colonia Benítez,Única,RNEd,NEA,2018m5,5,2018,NO COBRA,0,8,25,0,170,0,0,203,203
El Impenetrable,Única,PN,NEA,2018m5,5,2018,NO COBRA,0,13,170,0,0,0,0,183,183
Formosa,Única,RNat,NEA,2018m5,5,2018,NO COBRA,2,4,4,6,0,0,1,17,15
Iguazú,Única,PN,NEA,2018m5,5,2018,COBRA,54717,29017,3894,1282,0,17404,6677,112991,58274
Río Pilcomayo,Estero Poi,PN,NEA,2018m5,5,2018,NO COBRA,2,43,0,45,4,0,34,128,126
Río Pilcomayo,Laguna Blanca,PN,NEA,2018m5,5,2018,NO COBRA,38,104,241,125,0,0,185,693,655
Aconquija,Única,PN,NOA,2018m5,5,2018,NO COBRA,0,6,42,18,8,0,9,83,83
Baritú,Única,PN,NOA,2018m5,5,2018,NO COBRA,0,0,69,4,0,0,9,82,82
Calilegua,Única,PN,NOA,2018m5,5,2018,NO COBRA,125,240,209,425,732,0,483,2214,2089
Copo,Guayacán,PN,NOA,2018m5,5,2018,NO COBRA,0,0,0,0,0,0,0,0,0
Copo,Portada,PN,NOA,2018m5,5,2018,NO COBRA,0,0,0,0,0,0,0,0,0
El Rey,Única,PN,NOA,2018m5,5,2018,NO COBRA,37,19,30,16,0,0,25,127,90
Laguna de los Pozuelos,Única,MN,NOA,2018m5,5,2018,NO COBRA,38,54,17,0,0,1,9,119,81
Los Cardones,Recta del Tín Tín,PN,NOA,2018m5,5,2018,NO COBRA,356,4640,256,46,51,805,50,6204,5848
Los Cardones,Valle Encantado,PN,NOA,2018m5,5,2018,NO COBRA,0,0,0,0,0,0,0,0,0
Nogalar de los Toldos,Única,RNac,NOA,2018m5,5,2018,NO COBRA,1,0,15,36,41,0,22,115,114
Pizarro,Única,RNac,NOA,2018m5,5,2018,NO COBRA,0,0,0,0,0,0,0,0,0
Bosques Petrificados,Única,PN,PATAGONIA,2018m5,5,2018,NO COBRA,23,60,3,0,0,0,13,99,76
Lago Puelo,Única,PN,PATAGONIA,2018m5,5,2018,COBRA,117,2751,472,5737,50,1310,204,10641,10524
Laguna Blanca,Única,PN,PATAGONIA,2018m5,5,2018,NO COBRA,1,32,47,68,9,22,22,201,200
Lanín,Hua Hum,PN,PATAGONIA,2018m5,5,2018,NO COBRA,0,0,0,0,0,0,0,0,0
Lanín,Lago Huechulaufquen,PN,PATAGONIA,2018m5,5,2018,COBRA,145,1171,194,0,170,764,101,2545,2400
Lanín,Muelle Lago Lácar,PN,PATAGONIA,2018m5,5,2018,COBRA,120,793,447,0,52,702,36,2150,2030
Lanín,Quila Quina,PN,PATAGONIA,2018m5,5,2018,COBRA,73,1009,561,0,119,267,44,2073,2000
Lanín,Ruka Choroy,PN,PATAGONIA,2018m5,5,2018,NO COBRA,0,0,0,0,0,0,0,0,0
Lanín,Volcán Lanín,PN,PATAGONIA,2018m5,5,2018,NO COBRA,0,0,0,0,0,0,0,0,0
Lanín,Área Tromen,PN,PATAGONIA,2018m5,5,2018,NO COBRA,0,0,0,0,0,0,0,0,0
Lanín,Ñorkinko,PN,PATAGONIA,2018m5,5,2018,NO COBRA,0,0,0,0,0,0,0,0,0
Lihué Calel,Única,PN,PATAGONIA,2018m5,5,2018,NO COBRA,2,78,195,52,32,18,66,443,441
Los Alerces,Portada Centro,PN,PATAGONIA,2018m5,5,2018,COBRA,0,0,0,0,0,0,0,0,0
Los Alerces,Portada Norte,PN,PATAGONIA,2018m5,5,2018,COBRA,0,0,0,0,0,0,0,0,0
Los Alerces,Portada Sur,PN,PATAGONIA,2018m5,5,2018,COBRA,0,0,0,0,0,0,0,0,0
Los Alerces,Villa Futalaufquen,PN,PATAGONIA,2018m5,5,2018,NO COBRA,40,161,59,0,0,0,28,288,248
Los Glaciares,El Chaltén,PN,PATAGONIA,2018m5,5,2018,NO COBRA,2243,2244,0,0,0,0,0,4487,2244
Los Glaciares,Puerto Bandera,PN,PATAGONIA,2018m5,5,2018,COBRA,1422,2061,12,725,131,0,133,4484,3062
Los Glaciares,Puerto La Cruz,PN,PATAGONIA,2018m5,5,2018,NO COBRA,0,0,0,0,0,0,0,0,0
Los Glaciares,Puerto La Soledad,PN,PATAGONIA,2018m5,5,2018,COBRA,974,620,44,280,91,0,42,2051,1077
Los Glaciares,Puerto Lago Argentino,PN,PATAGONIA,2018m5,5,2018,COBRA,0,0,0,0,0,0,0,0,0
Los Glaciares,Río Mitre,PN,PATAGONIA,2018m5,5,2018,COBRA,6011,4475,971,653,560,1387,567,14624,8613
Monte León,Única,PN,PATAGONIA,2018m5,5,2018,NO COBRA,0,0,0,0,0,0,0,0,0
Nahuel Huapi,Lago Mascardi,PN,PATAGONIA,2018m5,5,2018,COBRA,1220,4093,2,3038,411,0,8,8772,7552
Nahuel Huapi,Puerto Pañuelo,PN,PATAGONIA,2018m5,5,2018,COBRA,1622,7210,199,2731,346,0,450,12558,10936
Nahuel Huapi,Quetrihué,PN,PATAGONIA,2018m5,5,2018,COBRA,159,984,171,500,252,0,102,2168,2009
Nahuel Huapi,Río Limay,PN,PATAGONIA,2018m5,5,2018,COBRA,0,0,0,0,0,0,0,0,0
Patagonia,Única,PN,PATAGONIA,2018m5,5,2018,NO COBRA,0,0,0,0,0,0,0,0,0
Perito Moreno,Única,PN,PATAGONIA,2018m5,5,2018,NO COBRA,0,0,0,0,0,0,0,0,0
Tierra del Fuego,Ruta Nacional 3,PN,PATAGONIA,2018m5,5,2018,COBRA,1760,2015,4335,0,26,192,1020,9348,7588
Tierra del Fuego,Tren del Fin del Mundo,PN,PATAGONIA,2018m5,5,2018,COBRA,1211,2873,709,0,0,448,492,5733,4522
Ciervo de los Pantanos,Única,PN,CENTRO,2018m6,6,2018,NO COBRA,4,137,238,86,88,0,268,821,817
El Leoncito,Única,PN,CENTRO,2018m6,6,2018,NO COBRA,29,396,482,108,0,0,0,1015,986
El Palmar,Única,PN,CENTRO,2018m6,6,2018,COBRA,50,1219,1168,263,284,2670,123,5777,5727
Iberá,Cambyretá,PN,CENTRO,2018m6,6,2018,NO COBRA,39,136,3,69,0,72,34,353,314
Iberá,San Nicolás,PN,CENTRO,2018m6,6,2018,NO COBRA,18,54,27,45,0,12,19,175,157
Mburucuyá,Única,PN,CENTRO,2018m6,6,2018,NO COBRA,2,101,97,110,0,0,133,443,441
Pre Delta,Única,PN,CENTRO,2018m6,6,2018,NO COBRA,16,845,1891,2798,52,12,985,6599,6583
Quebrada del Condorito,Única,PN,CENTRO,2018m6,6,2018,NO COBRA,110,177,661,56,0,0,0,1004,894
San Guillermo,Única,PN,CENTRO,2018m6,6,2018,NO COBRA,0,0,0,0,0,0,0,0,0
Sierra de las Quijadas,Única,PN,CENTRO,2018m6,6,2018,COBRA,37,319,212,0,19,266,55,908,871
Talampaya,Única,PN,CENTRO,2018m6,6,2018,COBRA,219,1233,54,0,233,1842,76,3657,3438
Chaco,Única,PN,NEA,2018m6,6,2018,NO COBRA,0,129,586,586,383,9,309,2002,2002
Colonia Benítez,Única,RNEd,NEA,2018m6,6,2018,NO COBRA,0,0,16,0,72,0,0,88,88
El Impenetrable,Única,PN,NEA,2018m6,6,2018,NO COBRA,3,188,84,0,0,0,0,275,272
Formosa,Única,RNat,NEA,2018m6,6,2018,NO COBRA,0,16,0,0,0,0,3,19,19
Iguazú,Única,PN,NEA,2018m6,6,2018,COBRA,52031,24958,1610,951,1228,17411,10120,108309,56278
Río Pilcomayo,Estero Poi,PN,NEA,2018m6,6,2018,NO COBRA,12,28,39,52,0,0,4,135,123
Río Pilcomayo,Laguna Blanca,PN,NEA,2018m6,6,2018,NO COBRA,42,38,156,151,0,15,216,618,576
Aconquija,Única,PN,NOA,2018m6,6,2018,NO COBRA,3,4,41,26,0,0,6,80,77
Baritú,Única,PN,NOA,2018m6,6,2018,NO COBRA,0,5,7,0,8,0,0,20,20
Calilegua,Única,PN,NOA,2018m6,6,2018,NO COBRA,117,337,271,224,378,0,154,1481,1364
Copo,Guayacán,PN,NOA,2018m6,6,2018,NO COBRA,0,0,0,0,0,0,0,0,0
Copo,Portada,PN,NOA,2018m6,6,2018,NO COBRA,0,0,0,0,0,0,0,0,0
El Rey,Única,PN,NOA,2018m6,6,2018,NO COBRA,2,15,115,0,0,0,43,175,173
Laguna de los Pozuelos,Única,MN,NOA,2018m6,6,2018,NO COBRA,25,13,35,10,0,0,0,83,58
Los Cardones,Recta del Tín Tín,PN,NOA,2018m6,6,2018,NO COBRA,512,11101,690,353,69,1374,153,14252,13740
Los Cardones,Valle Encantado,PN,NOA,2018m6,6,2018,NO COBRA,0,0,0,0,0,0,0,0,0
Nogalar de los Toldos,Única,RNac,NOA,2018m6,6,2018,NO COBRA,0,1,2,0,0,0,1,4,4
Pizarro,Única,RNac,NOA,2018m6,6,2018,NO COBRA,0,0,0,0,0,0,0,0,0
Bosques Petrificados,Única,PN,PATAGONIA,2018m6,6,2018,NO COBRA,1,43,16,0,59,0,2,121,120
Lago Puelo,Única,PN,PATAGONIA,2018m6,6,2018,COBRA,24,1191,79,4427,38,601,118,6478,6454
Laguna Blanca,Única,PN,PATAGONIA,2018m6,6,2018,NO COBRA,4,13,4,12,0,0,9,42,38
Lanín,Hua Hum,PN,PATAGONIA,2018m6,6,2018,NO COBRA,0,0,0,0,0,0,0,0,0
Lanín,Lago Huechulaufquen,PN,PATAGONIA,2018m6,6,2018,COBRA,0,463,0,0,0,312,0,775,775
Lanín,Muelle Lago Lácar,PN,PATAGONIA,2018m6,6,2018,COBRA,20,310,30,0,67,136,42,605,585
Lanín,Quila Quina,PN,PATAGONIA,2018m6,6,2018,COBRA,0,134,29,0,27,92,4,286,286
Lanín,Ruka Choroy,PN,PATAGONIA,2018m6,6,2018,NO COBRA,0,0,0,0,0,0,0,0,0
Lanín,Volcán Lanín,PN,PATAGONIA,2018m6,6,2018,NO COBRA,0,0,0,0,0,0,0,0,0
Lanín,Área Tromen,PN,PATAGONIA,2018m6,6,2018,NO COBRA,0,0,0,0,0,0,0,0,0
Lanín,Ñorkinko,PN,PATAGONIA,2018m6,6,2018,NO COBRA,0,0,0,0,0,0,0,0,0
Lihué Calel,Única,PN,PATAGONIA,2018m6,6,2018,NO COBRA,8,28,45,14,25,3,47,170,162
Los Alerces,Portada Centro,PN,PATAGONIA,2018m6,6,2018,COBRA,0,0,0,0,0,0,0,0,0
Los Alerces,Portada Norte,PN,PATAGONIA,2018m6,6,2018,COBRA,0,0,0,0,0,0,0,0,0
Los Alerces,Portada Sur,PN,PATAGONIA,2018m6,6,2018,COBRA,0,0,0,0,0,0,0,0,0
Los Alerces,Villa Futalaufquen,PN,PATAGONIA,2018m6,6,2018,NO COBRA,7,71,0,0,0,0,3,81,74
Los Glaciares,El Chaltén,PN,PATAGONIA,2018m6,6,2018,NO COBRA,690,977,0,0,0,0,0,1667,977
Los Glaciares,Puerto Bandera,PN,PATAGONIA,2018m6,6,2018,COBRA,688,1848,2,431,151,0,95,3215,2527
Los Glaciares,Puerto La Cruz,PN,PATAGONIA,2018m6,6,2018,NO COBRA,0,0,0,0,0,0,0,0,0
Los Glaciares,Puerto La Soledad,PN,PATAGONIA,2018m6,6,2018,COBRA,0,0,0,0,0,0,0,0,0
Los Glaciares,Puerto Lago Argentino,PN,PATAGONIA,2018m6,6,2018,COBRA,0,0,0,0,0,0,0,0,0
Los Glaciares,Río Mitre,PN,PATAGONIA,2018m6,6,2018,COBRA,3671,2499,224,504,278,716,521,8413,4742
Monte León,Única,PN,PATAGONIA,2018m6,6,2018,NO COBRA,0,0,0,0,0,0,0,0,0
Nahuel Huapi,Lago Mascardi,PN,PATAGONIA,2018m6,6,2018,COBRA,854,3858,312,1352,418,0,378,7172,6318
Nahuel Huapi,Puerto Pañuelo,PN,PATAGONIA,2018m6,6,2018,COBRA,1953,8947,29,3387,1441,0,813,16570,14617
Nahuel Huapi,Quetrihué,PN,PATAGONIA,2018m6,6,2018,COBRA,34,713,79,283,83,0,98,1290,1256
Nahuel Huapi,Río Limay,PN,PATAGONIA,2018m6,6,2018,COBRA,0,0,0,0,0,0,0,0,0
Patagonia,Única,PN,PATAGONIA,2018m6,6,2018,NO COBRA,0,0,0,0,0,0,0,0,0
Perito Moreno,Única,PN,PATAGONIA,2018m6,6,2018,NO COBRA,0,0,0,0,0,0,0,0,0
Tierra del Fuego,Ruta Nacional 3,PN,PATAGONIA,2018m6,6,2018,COBRA,733,1644,1903,0,0,64,548,4892,4159
Tierra del Fuego,Tren del Fin del Mundo,PN,PATAGONIA,2018m6,6,2018,COBRA,1246,3117,680,0,0,616,1132,6791,5545
Ciervo de los Pantanos,Única,PN,CENTRO,2018m7,7,2018,NO COBRA,0,59,443,130,309,2,195,1138,1138
El Leoncito,Única,PN,CENTRO,2018m7,7,2018,NO COBRA,121,2190,1225,225,0,0,0,3761,3640
El Palmar,Única,PN,CENTRO,2018m7,7,2018,COBRA,45,6801,2222,277,1526,5008,2712,18591,18546
Iberá,Cambyretá,PN,CENTRO,2018m7,7,2018,NO COBRA,96,626,67,306,48,38,262,1443,1347
Iberá,San Nicolás,PN,CENTRO,2018m7,7,2018,NO COBRA,36,250,220,251,7,16,123,903,867
Mburucuyá,Única,PN,CENTRO,2018m7,7,2018,NO COBRA,22,609,289,205,47,0,559,1731,1709
Pre Delta,Única,PN,CENTRO,2018m7,7,2018,NO COBRA,78,1879,1592,2917,0,61,2105,8632,8554
Quebrada del Condorito,Única,PN,CENTRO,2018m7,7,2018,NO COBRA,386,3277,1174,98,0,0,0,4935,4549
San Guillermo,Única,PN,CENTRO,2018m7,7,2018,NO COBRA,0,0,0,0,0,0,0,0,0
Sierra de las Quijadas,Única,PN,CENTRO,2018m7,7,2018,COBRA,75,3241,827,17,1098,1187,1365,7810,7735
Talampaya,Única,PN,CENTRO,2018m7,7,2018,COBRA,272,14055,378,39,1163,3878,2822,22607,22335
Chaco,Única,PN,NEA,2018m7,7,2018,NO COBRA,29,391,846,836,5,20,962,3089,3060
Colonia Benítez,Única,RNEd,NEA,2018m7,7,2018,NO COBRA,0,365,39,3,126,0,0,533,533
El Impenetrable,Única,PN,NEA,2018m7,7,2018,NO COBRA,12,138,304,30,0,0,0,484,472
Formosa,Única,RNat,NEA,2018m7,7,2018,NO COBRA,8,47,0,21,4,0,19,99,91
Iguazú,Única,PN,NEA,2018m7,7,2018,COBRA,50266,91340,6050,1912,280,21627,63390,234865,184599
Río Pilcomayo,Estero Poi,PN,NEA,2018m7,7,2018,NO COBRA,31,262,132,53,0,2,96,576,545
Río Pilcomayo,Laguna Blanca,PN,NEA,2018m7,7,2018,NO COBRA,23,628,314,443,0,2,363,1773,1750
Aconquija,Única,PN,NOA,2018m7,7,2018,NO COBRA,24,75,32,57,13,0,63,264,240
Baritú,Única,PN,NOA,2018m7,7,2018,NO COBRA,19,39,18,1,0,0,8,85,66
Calilegua,Única,PN,NOA,2018m7,7,2018,NO COBRA,190,2847,746,995,472,0,661,5911,5721
Copo,Guayacán,PN,NOA,2018m7,7,2018,NO COBRA,0,0,0,0,0,0,0,0,0
Copo,Portada,PN,NOA,2018m7,7,2018,NO COBRA,0,0,0,0,0,0,0,0,0
El Rey,Única,PN,NOA,2018m7,7,2018,NO COBRA,43,66,195,0,0,0,162,466,423
Laguna de los Pozuelos,Única,MN,NOA,2018m7,7,2018,NO COBRA,32,125,19,14,38,0,34,262,230
Los Cardones,Recta del Tín Tín,PN,NOA,2018m7,7,2018,NO COBRA,786,7001,717,393,20,4019,78,13014,12228
Los Cardones,Valle Encantado,PN,NOA,2018m7,7,2018,NO COBRA,0,0,0,0,0,0,0,0,0
Nogalar de los Toldos,Única,RNac,NOA,2018m7,7,2018,NO COBRA,15,27,18,22,0,15,6,103,88
Pizarro,Única,RNac,NOA,2018m7,7,2018,NO COBRA,0,0,0,0,0,0,0,0,0
Bosques Petrificados,Única,PN,PATAGONIA,2018m7,7,2018,NO COBRA,17,16,46,18,0,0,32,129,112
Lago Puelo,Única,PN,PATAGONIA,2018m7,7,2018,COBRA,87,3962,472,6278,125,312,695,11931,11844
Laguna Blanca,Única,PN,PATAGONIA,2018m7,7,2018,NO COBRA,3,63,38,49,49,0,80,282,279
Lanín,Hua Hum,PN,PATAGONIA,2018m7,7,2018,NO COBRA,0,0,0,0,0,0,0,0,0
Lanín,Lago Huechulaufquen,PN,PATAGONIA,2018m7,7,2018,COBRA,0,928,0,0,189,370,117,1604,1604
Lanín,Muelle Lago Lácar,PN,PATAGONIA,2018m7,7,2018,COBRA,81,1382,318,0,94,191,497,2563,2482
Lanín,Quila Quina,PN,PATAGONIA,2018m7,7,2018,COBRA,23,775,208,0,86,100,64,1256,1233
Lanín,Ruka Choroy,PN,PATAGONIA,2018m7,7,2018,NO COBRA,0,0,0,0,0,0,0,0,0
Lanín,Volcán Lanín,PN,PATAGONIA,2018m7,7,2018,NO COBRA,0,0,0,0,0,0,0,0,0
Lanín,Área Tromen,PN,PATAGONIA,2018m7,7,2018,NO COBRA,0,0,0,0,0,0,0,0,0
Lanín,Ñorkinko,PN,PATAGONIA,2018m7,7,2018,NO COBRA,0,0,0,0,0,0,0,0,0
Lihué Calel,Única,PN,PATAGONIA,2018m7,7,2018,NO COBRA,2,177,91,57,0,4,89,420,418
Los Alerces,Portada Centro,PN,PATAGONIA,2018m7,7,2018,COBRA,0,0,0,0,0,0,0,0,0
Los Alerces,Portada Norte,PN,PATAGONIA,2018m7,7,2018,COBRA,0,0,0,0,0,0,0,0,0
Los Alerces,Portada Sur,PN,PATAGONIA,2018m7,7,2018,COBRA,0,0,0,0,0,0,0,0,0
Los Alerces,Villa Futalaufquen,PN,PATAGONIA,2018m7,7,2018,NO COBRA,33,943,19,2,1,1,286,1285,1252
Los Glaciares,El Chaltén,PN,PATAGONIA,2018m7,7,2018,NO COBRA,715,3029,0,0,0,0,0,3744,3029
Los Glaciares,Puerto Bandera,PN,PATAGONIA,2018m7,7,2018,COBRA,1980,2610,98,514,283,0,415,5900,3920
Los Glaciares,Puerto La Cruz,PN,PATAGONIA,2018m7,7,2018,NO COBRA,0,0,0,0,0,0,0,0,0
Los Glaciares,Puerto La Soledad,PN,PATAGONIA,2018m7,7,2018,COBRA,0,0,0,0,0,0,0,0,0
Los Glaciares,Puerto Lago Argentino,PN,PATAGONIA,2018m7,7,2018,COBRA,0,0,0,0,0,0,0,0,0
Los Glaciares,Río Mitre,PN,PATAGONIA,2018m7,7,2018,COBRA,6870,5455,1709,1256,1095,575,1676,18636,11766
Monte León,Única,PN,PATAGONIA,2018m7,7,2018,NO COBRA,0,0,0,0,0,0,0,0,0
Nahuel Huapi,Lago Mascardi,PN,PATAGONIA,2018m7,7,2018,COBRA,2330,7492,198,1858,1719,0,247,13844,11514
Nahuel Huapi,Puerto Pañuelo,PN,PATAGONIA,2018m7,7,2018,COBRA,5569,20257,336,4847,19123,0,5821,55953,50384
Nahuel Huapi,Quetrihué,PN,PATAGONIA,2018m7,7,2018,COBRA,382,1845,822,1139,1913,0,693,6794,6412
Nahuel Huapi,Río Limay,PN,PATAGONIA,2018m7,7,2018,COBRA,0,0,0,0,0,0,0,0,0
Patagonia,Única,PN,PATAGONIA,2018m7,7,2018,NO COBRA,0,0,0,0,0,0,0,0,0
Perito Moreno,Única,PN,PATAGONIA,2018m7,7,2018,NO COBRA,0,0,0,0,0,0,0,0,0
Tierra del Fuego,Ruta Nacional 3,PN,PATAGONIA,2018m7,7,2018,COBRA,1292,2240,4546,0,11,42,1404,9535,8243
Tierra del Fuego,Tren del Fin del Mundo,PN,PATAGONIA,2018m7,7,2018,COBRA,4430,5309,915,0,0,1180,2780,14614,10184
Ciervo de los Pantanos,Única,PN,CENTRO,2018m8,8,2018,NO COBRA,8,176,1234,614,77,0,392,2501,2493
El Leoncito,Única,PN,CENTRO,2018m8,8,2018,NO COBRA,53,569,811,53,0,0,0,1486,1433
El Palmar,Única,PN,CENTRO,2018m8,8,2018,COBRA,96,3863,1875,695,480,1501,4046,12556,12460
Iberá,Cambyretá,PN,CENTRO,2018m8,8,2018,NO COBRA,89,225,5,93,7,241,88,748,659
Iberá,San Nicolás,PN,CENTRO,2018m8,8,2018,NO COBRA,69,131,55,177,172,26,22,652,583
Mburucuyá,Única,PN,CENTRO,2018m8,8,2018,NO COBRA,22,217,240,313,53,0,529,1374,1352
Pre Delta,Única,PN,CENTRO,2018m8,8,2018,NO COBRA,82,3882,5486,6236,41,147,2229,18103,18021
Quebrada del Condorito,Única,PN,CENTRO,2018m8,8,2018,NO COBRA,248,880,1372,157,0,0,0,2657,2409
San Guillermo,Única,PN,CENTRO,2018m8,8,2018,NO COBRA,0,0,0,0,0,0,0,0,0
Sierra de las Quijadas,Única,PN,CENTRO,2018m8,8,2018,COBRA,47,1155,444,19,246,792,141,2844,2797
Talampaya,Única,PN,CENTRO,2018m8,8,2018,COBRA,418,3707,99,0,602,3760,323,8909,8491
Chaco,Única,PN,NEA,2018m8,8,2018,NO COBRA,11,90,808,322,153,4,433,1821,1810
Colonia Benítez,Única,RNEd,NEA,2018m8,8,2018,NO COBRA,3,17,34,0,0,0,69,123,120
El Impenetrable,Única,PN,NEA,2018m8,8,2018,NO COBRA,0,28,63,0,0,0,0,91,91
Formosa,Única,RNat,NEA,2018m8,8,2018,NO COBRA,0,2,0,0,1,0,2,5,5
Iguazú,Única,PN,NEA,2018m8,8,2018,COBRA,52722,78837,3733,1976,2813,25277,12848,178206,125484
Río Pilcomayo,Estero Poi,PN,NEA,2018m8,8,2018,NO COBRA,14,98,78,84,0,3,78,355,341
Río Pilcomayo,Laguna Blanca,PN,NEA,2018m8,8,2018,NO COBRA,42,190,219,490,0,1,164,1106,1064
Aconquija,Única,PN,NOA,2018m8,8,2018,NO COBRA,3,42,68,512,16,0,0,641,638
Baritú,Única,PN,NOA,2018m8,8,2018,NO COBRA,115,8,0,21,94,0,3,241,126
Calilegua,Única,PN,NOA,2018m8,8,2018,NO COBRA,169,518,315,431,322,0,178,1933,1764
Copo,Guayacán,PN,NOA,2018m8,8,2018,NO COBRA,0,0,0,0,0,0,0,0,0
Copo,Portada,PN,NOA,2018m8,8,2018,NO COBRA,0,0,0,0,0,0,0,0,0
El Rey,Única,PN,NOA,2018m8,8,2018,NO COBRA,8,20,65,0,0,0,45,138,130
Laguna de los Pozuelos,Única,MN,NOA,2018m8,8,2018,NO COBRA,76,57,30,1,73,1,12,250,174
Los Cardones,Recta del Tín Tín,PN,NOA,2018m8,8,2018,NO COBRA,419,11128,323,173,0,2215,49,14307,13888
Los Cardones,Valle Encantado,PN,NOA,2018m8,8,2018,NO COBRA,0,0,0,0,0,0,0,0,0
Nogalar de los Toldos,Única,RNac,NOA,2018m8,8,2018,NO COBRA,12,13,12,6,0,0,33,76,64
Pizarro,Única,RNac,NOA,2018m8,8,2018,NO COBRA,0,0,0,0,0,0,0,0,0
Bosques Petrificados,Única,PN,PATAGONIA,2018m8,8,2018,NO COBRA,24,36,61,16,0,2,19,158,134
Lago Puelo,Única,PN,PATAGONIA,2018m8,8,2018,COBRA,69,3157,560,5088,182,303,319,9678,9609
Laguna Blanca,Única,PN,PATAGONIA,2018m8,8,2018,NO COBRA,11,159,133,48,0,0,31,382,371
Lanín,Hua Hum,PN,PATAGONIA,2018m8,8,2018,NO COBRA,0,0,0,0,0,0,0,0,0
Lanín,Lago Huechulaufquen,PN,PATAGONIA,2018m8,8,2018,COBRA,193,665,0,0,160,159,134,1311,1118
Lanín,Muelle Lago Lácar,PN,PATAGONIA,2018m8,8,2018,COBRA,178,1599,247,0,263,316,365,2968,2790
Lanín,Quila Quina,PN,PATAGONIA,2018m8,8,2018,COBRA,24,594,310,0,144,105,76,1253,1229
Lanín,Ruka Choroy,PN,PATAGONIA,2018m8,8,2018,NO COBRA,0,0,0,0,0,0,0,0,0
Lanín,Volcán Lanín,PN,PATAGONIA,2018m8,8,2018,NO COBRA,0,0,0,0,0,0,0,0,0
Lanín,Área Tromen,PN,PATAGONIA,2018m8,8,2018,NO COBRA,0,0,0,0,0,0,0,0,0
Lanín,Ñorkinko,PN,PATAGONIA,2018m8,8,2018,NO COBRA,0,0,0,0,0,0,0,0,0
Lihué Calel,Única,PN,PATAGONIA,2018m8,8,2018,NO COBRA,4,102,166,55,267,7,87,688,684
Los Alerces,Portada Centro,PN,PATAGONIA,2018m8,8,2018,COBRA,0,0,0,0,0,0,0,0,0
Los Alerces,Portada Norte,PN,PATAGONIA,2018m8,8,2018,COBRA,0,0,0,0,0,0,0,0,0
Los Alerces,Portada Sur,PN,PATAGONIA,2018m8,8,2018,COBRA,0,0,0,0,0,0,0,0,0
Los Alerces,Villa Futalaufquen,PN,PATAGONIA,2018m8,8,2018,NO COBRA,44,542,29,24,0,0,293,932,888
Los Glaciares,El Chaltén,PN,PATAGONIA,2018m8,8,2018,NO COBRA,3683,1882,0,0,0,0,0,5565,1882
Los Glaciares,Puerto Bandera,PN,PATAGONIA,2018m8,8,2018,COBRA,2274,2825,44,624,565,0,231,6563,4289
Los Glaciares,Puerto La Cruz,PN,PATAGONIA,2018m8,8,2018,NO COBRA,0,0,0,0,0,0,0,0,0
Los Glaciares,Puerto La Soledad,PN,PATAGONIA,2018m8,8,2018,COBRA,0,0,0,0,0,0,0,0,0
Los Glaciares,Puerto Lago Argentino,PN,PATAGONIA,2018m8,8,2018,COBRA,0,0,0,0,0,0,0,0,0
Los Glaciares,Río Mitre,PN,PATAGONIA,2018m8,8,2018,COBRA,8826,6360,783,1137,1329,1295,713,20443,11617
Monte León,Única,PN,PATAGONIA,2018m8,8,2018,NO COBRA,0,0,0,0,0,0,0,0,0
Nahuel Huapi,Lago Mascardi,PN,PATAGONIA,2018m8,8,2018,COBRA,1694,2512,12,1295,388,0,15,5916,4222
Nahuel Huapi,Puerto Pañuelo,PN,PATAGONIA,2018m8,8,2018,COBRA,8969,11676,4759,3349,16147,0,1291,46191,37222
Nahuel Huapi,Quetrihué,PN,PATAGONIA,2018m8,8,2018,COBRA,217,1441,376,1118,374,0,311,3837,3620
Nahuel Huapi,Río Limay,PN,PATAGONIA,2018m8,8,2018,COBRA,0,0,0,0,0,0,0,0,0
Patagonia,Única,PN,PATAGONIA,2018m8,8,2018,NO COBRA,0,0,0,0,0,0,0,0,0
Perito Moreno,Única,PN,PATAGONIA,2018m8,8,2018,NO COBRA,0,0,0,0,0,0,0,0,0
Tierra del Fuego,Ruta Nacional 3,PN,PATAGONIA,2018m8,8,2018,COBRA,1272,2508,3053,0,175,32,1328,8368,7096
Tierra del Fuego,Tren del Fin del Mundo,PN,PATAGONIA,2018m8,8,2018,COBRA,2924,3284,608,0,0,547,1395,8758,5834
Ciervo de los Pantanos,Única,PN,CENTRO,2018m9,9,2018,NO COBRA,2,353,1163,133,36,0,732,2419,2417
El Leoncito,Única,PN,CENTRO,2018m9,9,2018,NO COBRA,309,946,707,282,0,0,0,2244,1935
El Palmar,Única,PN,CENTRO,2018m9,9,2018,COBRA,63,2530,1758,416,956,11970,364,18057,17994
Iberá,Cambyretá,PN,CENTRO,2018m9,9,2018,NO COBRA,99,165,8,118,2,103,42,537,438
Iberá,San Nicolás,PN,CENTRO,2018m9,9,2018,NO COBRA,35,99,142,186,158,63,74,757,722
Mburucuyá,Única,PN,CENTRO,2018m9,9,2018,NO COBRA,18,154,95,125,0,0,250,642,624
Pre Delta,Única,PN,CENTRO,2018m9,9,2018,NO COBRA,73,1462,3647,5089,505,154,2094,13024,12951
Quebrada del Condorito,Única,PN,CENTRO,2018m9,9,2018,NO COBRA,337,609,1670,271,0,0,0,2887,2550
San Guillermo,Única,PN,CENTRO,2018m9,9,2018,NO COBRA,0,0,7,0,0,0,0,7,7
Sierra de las Quijadas,Única,PN,CENTRO,2018m9,9,2018,COBRA,40,718,450,0,113,1047,148,2516,2476
Talampaya,Única,PN,CENTRO,2018m9,9,2018,COBRA,356,3280,129,0,590,2430,252,7037,6681
Chaco,Única,PN,NEA,2018m9,9,2018,NO COBRA,5,89,480,207,567,2,184,1534,1529
Colonia Benítez,Única,RNEd,NEA,2018m9,9,2018,NO COBRA,0,6,58,18,262,0,9,353,353
El Impenetrable,Única,PN,NEA,2018m9,9,2018,NO COBRA,0,15,7,0,0,0,0,22,22
Formosa,Única,RNat,NEA,2018m9,9,2018,NO COBRA,0,0,0,0,0,0,0,0,0
Iguazú,Única,PN,NEA,2018m9,9,2018,COBRA,81365,58852,3152,2416,6147,15781,21347,189060,107695
Río Pilcomayo,Estero Poi,PN,NEA,2018m9,9,2018,NO COBRA,11,56,25,72,0,11,36,211,200
Río Pilcomayo,Laguna Blanca,PN,NEA,2018m9,9,2018,NO COBRA,24,80,337,772,20,0,758,1991,1967
Aconquija,Única,PN,NOA,2018m9,9,2018,NO COBRA,8,51,75,531,27,0,453,1145,1137
Baritú,Única,PN,NOA,2018m9,9,2018,NO COBRA,9,22,3,2,0,0,0,36,27
Calilegua,Única,PN,NOA,2018m9,9,2018,NO COBRA,104,574,186,565,702,0,321,2452,2348
Copo,Guayacán,PN,NOA,2018m9,9,2018,NO COBRA,0,0,0,0,0,0,0,0,0
Copo,Portada,PN,NOA,2018m9,9,2018,NO COBRA,0,0,0,0,0,0,0,0,0
El Rey,Única,PN,NOA,2018m9,9,2018,NO COBRA,27,38,83,0,0,0,100,248,221
Laguna de los Pozuelos,Única,MN,NOA,2018m9,9,2018,NO COBRA,60,43,10,4,31,0,4,152,92
Los Cardones,Recta del Tín Tín,PN,NOA,2018m9,9,2018,NO COBRA,1610,9781,160,95,108,1130,63,12947,11337
Los Cardones,Valle Encantado,PN,NOA,2018m9,9,2018,NO COBRA,0,0,0,0,0,0,0,0,0
Nogalar de los Toldos,Única,RNac,NOA,2018m9,9,2018,NO COBRA,7,24,12,37,339,0,12,431,424
Pizarro,Única,RNac,NOA,2018m9,9,2018,NO COBRA,0,0,0,0,0,0,0,0,0
Bosques Petrificados,Única,PN,PATAGONIA,2018m9,9,2018,NO COBRA,11,19,16,3,57,14,0,120,109
Lago Puelo,Única,PN,PATAGONIA,2018m9,9,2018,COBRA,134,2496,230,6541,90,663,827,10981,10847
Laguna Blanca,Única,PN,PATAGONIA,2018m9,9,2018,NO COBRA,4,28,37,71,128,0,50,318,314
Lanín,Hua Hum,PN,PATAGONIA,2018m9,9,2018,NO COBRA,0,0,0,0,0,0,0,0,0
Lanín,Lago Huechulaufquen,PN,PATAGONIA,2018m9,9,2018,COBRA,0,906,154,0,172,549,0,1781,1781
Lanín,Muelle Lago Lácar,PN,PATAGONIA,2018m9,9,2018,COBRA,235,545,49,0,109,332,104,1374,1139
Lanín,Quila Quina,PN,PATAGONIA,2018m9,9,2018,COBRA,41,820,139,0,57,90,111,1258,1217
Lanín,Ruka Choroy,PN,PATAGONIA,2018m9,9,2018,NO COBRA,0,0,0,0,0,0,0,0,0
Lanín,Volcán Lanín,PN,PATAGONIA,2018m9,9,2018,NO COBRA,0,0,0,0,0,0,0,0,0
Lanín,Área Tromen,PN,PATAGONIA,2018m9,9,2018,NO COBRA,0,0,0,0,0,0,0,0,0
Lanín,Ñorkinko,PN,PATAGONIA,2018m9,9,2018,NO COBRA,0,0,0,0,0,0,0,0,0
Lihué Calel,Única,PN,PATAGONIA,2018m9,9,2018,NO COBRA,13,60,123,84,358,4,49,691,678
Los Alerces,Portada Centro,PN,PATAGONIA,2018m9,9,2018,COBRA,0,0,0,0,0,0,0,0,0
Los Alerces,Portada Norte,PN,PATAGONIA,2018m9,9,2018,COBRA,0,0,0,0,0,0,0,0,0
Los Alerces,Portada Sur,PN,PATAGONIA,2018m9,9,2018,COBRA,0,0,0,0,0,0,0,0,0
Los Alerces,Villa Futalaufquen,PN,PATAGONIA,2018m9,9,2018,NO COBRA,69,518,50,17,133,89,177,1053,984
Los Glaciares,El Chaltén,PN,PATAGONIA,2018m9,9,2018,NO COBRA,3042,3416,0,0,0,0,0,6458,3416
Los Glaciares,Puerto Bandera,PN,PATAGONIA,2018m9,9,2018,COBRA,5712,5022,26,1607,295,0,355,13017,7305
Los Glaciares,Puerto La Cruz,PN,PATAGONIA,2018m9,9,2018,NO COBRA,0,0,0,0,0,0,0,0,0
Los Glaciares,Puerto La Soledad,PN,PATAGONIA,2018m9,9,2018,COBRA,0,0,0,0,0,0,0,0,0
Los Glaciares,Puerto Lago Argentino,PN,PATAGONIA,2018m9,9,2018,COBRA,0,0,0,0,0,0,0,0,0
Los Glaciares,Río Mitre,PN,PATAGONIA,2018m9,9,2018,COBRA,20432,5910,1316,1781,900,3423,1926,35688,15256
Monte León,Única,PN,PATAGONIA,2018m9,9,2018,NO COBRA,0,0,0,0,0,0,0,0,0
Nahuel Huapi,Lago Mascardi,PN,PATAGONIA,2018m9,9,2018,COBRA,1187,859,749,1058,1115,0,1112,6080,4893
Nahuel Huapi,Puerto Pañuelo,PN,PATAGONIA,2018m9,9,2018,COBRA,4606,7082,454,2970,20836,0,1983,37931,33325
Nahuel Huapi,Quetrihué,PN,PATAGONIA,2018m9,9,2018,COBRA,718,2167,411,904,527,0,540,5267,4549
Nahuel Huapi,Río Limay,PN,PATAGONIA,2018m9,9,2018,COBRA,0,0,0,0,0,0,0,0,0
Patagonia,Única,PN,PATAGONIA,2018m9,9,2018,NO COBRA,0,0,0,0,0,0,0,0,0
Perito Moreno,Única,PN,PATAGONIA,2018m9,9,2018,NO COBRA,0,0,0,0,0,0,0,0,0
Tierra del Fuego,Ruta Nacional 3,PN,PATAGONIA,2018m9,9,2018,COBRA,1618,3708,4199,0,415,179,1652,11771,10153
Tierra del Fuego,Tren del Fin del Mundo,PN,PATAGONIA,2018m9,9,2018,COBRA,3126,7545,1077,0,0,1198,1636,14582,11456
Ciervo de los Pantanos,Única,PN,CENTRO,2018m10,10,2018,NO COBRA,87,633,1416,511,89,62,916,3714,3627
El Leoncito,Única,PN,CENTRO,2018m10,10,2018,NO COBRA,234,1050,848,237,0,0,0,2369,2135
El Palmar,Única,PN,CENTRO,2018m10,10,2018,COBRA,100,5507,4091,492,12048,1899,4763,28900,28800
Iberá,Cambyretá,PN,CENTRO,2018m10,10,2018,NO COBRA,143,314,32,269,159,44,181,1142,999
Iberá,San Nicolás,PN,CENTRO,2018m10,10,2018,NO COBRA,49,162,103,123,3,50,34,524,475
Mburucuyá,Única,PN,CENTRO,2018m10,10,2018,NO COBRA,37,134,246,217,123,4,271,1032,995
Pre Delta,Única,PN,CENTRO,2018m10,10,2018,NO COBRA,67,2891,2461,3684,242,17,2028,11390,11323
Quebrada del Condorito,Única,PN,CENTRO,2018m10,10,2018,NO COBRA,206,747,1883,342,0,0,0,3178,2972
San Guillermo,Única,PN,CENTRO,2018m10,10,2018,NO COBRA,0,0,0,0,0,0,0,0,0
Sierra de las Quijadas,Única,PN,CENTRO,2018m10,10,2018,COBRA,112,902,355,1,222,530,105,2227,2115
Talampaya,Única,PN,CENTRO,2018m10,10,2018,COBRA,443,3632,96,0,333,5435,276,10215,9772
Chaco,Única,PN,NEA,2018m10,10,2018,NO COBRA,10,170,396,317,517,3,161,1574,1564
Colonia Benítez,Única,RNEd,NEA,2018m10,10,2018,NO COBRA,0,0,61,17,575,0,22,675,675
El Impenetrable,Única,PN,NEA,2018m10,10,2018,NO COBRA,0,11,14,8,0,0,0,33,33
Formosa,Única,RNat,NEA,2018m10,10,2018,NO COBRA,0,4,0,0,1,0,2,7,7
Iguazú,Única,PN,NEA,2018m10,10,2018,COBRA,91908,74694,3642,3859,5696,24653,19700,224152,132244
Río Pilcomayo,Estero Poi,PN,NEA,2018m10,10,2018,NO COBRA,6,44,9,12,0,13,9,93,87
Río Pilcomayo,Laguna Blanca,PN,NEA,2018m10,10,2018,NO COBRA,9,121,149,330,115,0,118,842,833
Aconquija,Única,PN,NOA,2018m10,10,2018,NO COBRA,0,23,19,248,1,0,58,349,349
Baritú,Única,PN,NOA,2018m10,10,2018,NO COBRA,2,8,0,0,0,0,0,10,8
Calilegua,Única,PN,NOA,2018m10,10,2018,NO COBRA,97,873,440,460,640,0,109,2619,2522
Copo,Guayacán,PN,NOA,2018m10,10,2018,NO COBRA,0,0,0,0,0,0,0,0,0
Copo,Portada,PN,NOA,2018m10,10,2018,NO COBRA,0,0,0,0,0,0,0,0,0
El Rey,Única,PN,NOA,2018m10,10,2018,NO COBRA,14,28,33,0,0,0,71,146,132
Laguna de los Pozuelos,Única,MN,NOA,2018m10,10,2018,NO COBRA,119,94,35,19,1,0,7,275,156
Los Cardones,Recta del Tín Tín,PN,NOA,2018m10,10,2018,NO COBRA,1643,5848,396,63,200,3081,120,11351,9708
Los Cardones,Valle Encantado,PN,NOA,2018m10,10,2018,NO COBRA,0,0,0,0,0,0,0,0,0
Nogalar de los Toldos,Única,RNac,NOA,2018m10,10,2018,NO COBRA,2,1,20,24,94,0,0,141,139
Pizarro,Única,RNac,NOA,2018m10,10,2018,NO COBRA,0,0,0,0,0,0,0,0,0
Bosques Petrificados,Única,PN,PATAGONIA,2018m10,10,2018,NO COBRA,91,78,55,29,0,65,27,345,254
Lago Puelo,Única,PN,PATAGONIA,2018m10,10,2018,COBRA,214,3012,674,12378,133,2268,4586,23265,23051
Laguna Blanca,Única,PN,PATAGONIA,2018m10,10,2018,NO COBRA,10,88,161,99,42,0,72,472,462
Lanín,Hua Hum,PN,PATAGONIA,2018m10,10,2018,NO COBRA,0,0,0,0,0,0,0,0,0
Lanín,Lago Huechulaufquen,PN,PATAGONIA,2018m10,10,2018,COBRA,127,1367,0,0,0,514,157,2165,2038
Lanín,Muelle Lago Lácar,PN,PATAGONIA,2018m10,10,2018,COBRA,296,1792,380,0,133,539,151,3291,2995
Lanín,Quila Quina,PN,PATAGONIA,2018m10,10,2018,COBRA,47,1002,403,0,227,290,40,2009,1962
Lanín,Ruka Choroy,PN,PATAGONIA,2018m10,10,2018,NO COBRA,0,0,0,0,0,0,0,0,0
Lanín,Volcán Lanín,PN,PATAGONIA,2018m10,10,2018,NO COBRA,0,0,0,0,0,0,0,0,0
Lanín,Área Tromen,PN,PATAGONIA,2018m10,10,2018,NO COBRA,0,0,0,0,0,0,0,0,0
Lanín,Ñorkinko,PN,PATAGONIA,2018m10,10,2018,NO COBRA,0,0,0,0,0,0,0,0,0
Lihué Calel,Única,PN,PATAGONIA,2018m10,10,2018,NO COBRA,31,139,254,66,1115,19,142,1766,1735
Los Alerces,Portada Centro,PN,PATAGONIA,2018m10,10,2018,COBRA,0,0,0,0,0,0,0,0,0
Los Alerces,Portada Norte,PN,PATAGONIA,2018m10,10,2018,COBRA,0,0,0,0,0,0,0,0,0
Los Alerces,Portada Sur,PN,PATAGONIA,2018m10,10,2018,COBRA,0,0,0,0,0,0,0,0,0
Los Alerces,Villa Futalaufquen,PN,PATAGONIA,2018m10,10,2018,NO COBRA,290,1158,43,4,98,178,116,1887,1597
Los Glaciares,El Chaltén,PN,PATAGONIA,2018m10,10,2018,NO COBRA,6551,6490,0,0,0,0,0,13041,6490
Los Glaciares,Puerto Bandera,PN,PATAGONIA,2018m10,10,2018,COBRA,6313,6482,23,3861,599,0,312,17590,11277
Los Glaciares,Puerto La Cruz,PN,PATAGONIA,2018m10,10,2018,NO COBRA,0,0,0,0,0,0,0,0,0
Los Glaciares,Puerto La Soledad,PN,PATAGONIA,2018m10,10,2018,COBRA,1207,0,0,0,0,0,0,1207,0
Los Glaciares,Puerto Lago Argentino,PN,PATAGONIA,2018m10,10,2018,COBRA,0,0,0,0,0,0,0,0,0
Los Glaciares,Río Mitre,PN,PATAGONIA,2018m10,10,2018,COBRA,37275,11548,1742,2899,1739,9444,2763,67410,30135
Monte León,Única,PN,PATAGONIA,2018m10,10,2018,NO COBRA,0,0,0,0,0,0,0,0,0
Nahuel Huapi,Lago Mascardi,PN,PATAGONIA,2018m10,10,2018,COBRA,1766,3356,955,3012,1303,0,1710,12102,10336
Nahuel Huapi,Puerto Pañuelo,PN,PATAGONIA,2018m10,10,2018,COBRA,5427,6400,543,5371,7828,0,765,26334,20907
Nahuel Huapi,Quetrihué,PN,PATAGONIA,2018m10,10,2018,COBRA,643,2572,727,870,509,0,253,5574,4931
Nahuel Huapi,Río Limay,PN,PATAGONIA,2018m10,10,2018,COBRA,0,0,0,0,2302,0,0,2302,2302
Patagonia,Única,PN,PATAGONIA,2018m10,10,2018,NO COBRA,0,0,0,0,0,0,0,0,0
Perito Moreno,Única,PN,PATAGONIA,2018m10,10,2018,NO COBRA,13,25,12,2,28,0,2,82,69
Tierra del Fuego,Ruta Nacional 3,PN,PATAGONIA,2018m10,10,2018,COBRA,6558,5812,6827,0,354,4015,4168,27734,21176
Tierra del Fuego,Tren del Fin del Mundo,PN,PATAGONIA,2018m10,10,2018,COBRA,7543,7053,171,0,344,3778,767,19656,12113
Ciervo de los Pantanos,Única,PN,CENTRO,2018m11,11,2018,NO COBRA,0,0,0,0,0,0,0,0,0
El Leoncito,Única,PN,CENTRO,2018m11,11,2018,NO COBRA,286,672,511,255,0,0,0,1724,1438
El Palmar,Única,PN,CENTRO,2018m11,11,2018,COBRA,216,3894,1814,320,7585,4215,641,18685,18469
Iberá,Cambyretá,PN,CENTRO,2018m11,11,2018,NO COBRA,145,168,46,120,163,18,54,714,569
Iberá,San Nicolás,PN,CENTRO,2018m11,11,2018,NO COBRA,93,74,25,65,140,0,11,408,315
Mburucuyá,Única,PN,CENTRO,2018m11,11,2018,NO COBRA,16,101,103,70,64,16,191,561,545
Pre Delta,Única,PN,CENTRO,2018m11,11,2018,NO COBRA,56,1907,2581,2829,485,43,2466,10367,10311
Quebrada del Condorito,Única,PN,CENTRO,2018m11,11,2018,NO COBRA,323,408,1024,285,0,0,0,2040,1717
San Guillermo,Única,PN,CENTRO,2018m11,11,2018,NO COBRA,0,2,0,0,0,0,0,2,2
Sierra de las Quijadas,Única,PN,CENTRO,2018m11,11,2018,COBRA,95,1249,30,2,203,313,80,1972,1877
Talampaya,Única,PN,CENTRO,2018m11,11,2018,COBRA,963,2630,108,0,153,2402,128,6384,5421
Chaco,Única,PN,NEA,2018m11,11,2018,NO COBRA,40,198,231,112,218,0,92,891,851
Colonia Benítez,Única,RNEd,NEA,2018m11,11,2018,NO COBRA,0,3,16,0,84,0,7,110,110
El Impenetrable,Única,PN,NEA,2018m11,11,2018,NO COBRA,1,32,12,3,1,2,1,52,51
Formosa,Única,RNat,NEA,2018m11,11,2018,NO COBRA,2,4,0,4,0,0,0,10,8
Iguazú,Única,PN,NEA,2018m11,11,2018,COBRA,85141,49372,4722,2570,3771,9769,10050,165395,80254
Río Pilcomayo,Estero Poi,PN,NEA,2018m11,11,2018,NO COBRA,1,9,4,2,0,0,2,18,17
Río Pilcomayo,Laguna Blanca,PN,NEA,2018m11,11,2018,NO COBRA,8,44,236,322,0,0,202,812,804
Aconquija,Única,PN,NOA,2018m11,11,2018,NO COBRA,0,0,0,0,0,0,0,0,0
Baritú,Única,PN,NOA,2018m11,11,2018,NO COBRA,0,0,0,0,0,0,0,0,0
Calilegua,Única,PN,NOA,2018m11,11,2018,NO COBRA,205,382,211,256,1261,0,73,2388,2183
Copo,Guayacán,PN,NOA,2018m11,11,2018,NO COBRA,0,0,0,0,0,0,0,0,0
Copo,Portada,PN,NOA,2018m11,11,2018,NO COBRA,0,0,0,0,0,0,0,0,0
El Rey,Única,PN,NOA,2018m11,11,2018,NO COBRA,4,11,21,20,0,0,2,58,54
Laguna de los Pozuelos,Única,MN,NOA,2018m11,11,2018,NO COBRA,53,54,24,4,1,0,2,138,85
Los Cardones,Recta del Tín Tín,PN,NOA,2018m11,11,2018,NO COBRA,1242,8217,378,220,226,3446,91,13820,12578
Los Cardones,Valle Encantado,PN,NOA,2018m11,11,2018,NO COBRA,0,0,0,0,0,0,0,0,0
Nogalar de los Toldos,Única,RNac,NOA,2018m11,11,2018,NO COBRA,25,0,0,0,0,0,0,25,0
Pizarro,Única,RNac,NOA,2018m11,11,2018,NO COBRA,0,0,0,0,0,0,0,0,0
Bosques Petrificados,Única,PN,PATAGONIA,2018m11,11,2018,NO COBRA,182,15,110,53,93,17,51,521,339
Lago Puelo,Única,PN,PATAGONIA,2018m11,11,2018,COBRA,454,4085,909,9478,195,3778,1826,20725,20271
Laguna Blanca,Única,PN,PATAGONIA,2018m11,11,2018,NO COBRA,18,66,68,61,339,0,14,566,548
Lanín,Hua Hum,PN,PATAGONIA,2018m11,11,2018,NO COBRA,0,0,0,0,0,0,0,0,0
Lanín,Lago Huechulaufquen,PN,PATAGONIA,2018m11,11,2018,COBRA,319,1946,323,0,350,2284,0,5222,4903
Lanín,Muelle Lago Lácar,PN,PATAGONIA,2018m11,11,2018,COBRA,255,1507,672,0,480,476,56,3446,3191
Lanín,Quila Quina,PN,PATAGONIA,2018m11,11,2018,COBRA,149,1790,303,0,42,693,43,3020,2871
Lanín,Ruka Choroy,PN,PATAGONIA,2018m11,11,2018,NO COBRA,0,0,0,0,0,0,0,0,0
Lanín,Volcán Lanín,PN,PATAGONIA,2018m11,11,2018,NO COBRA,0,0,0,0,0,0,0,0,0
Lanín,Área Tromen,PN,PATAGONIA,2018m11,11,2018,NO COBRA,0,0,0,0,0,0,0,0,0
Lanín,Ñorkinko,PN,PATAGONIA,2018m11,11,2018,NO COBRA,0,0,0,0,0,0,0,0,0
Lihué Calel,Única,PN,PATAGONIA,2018m11,11,2018,NO COBRA,18,178,215,70,58,17,592,1148,1130
Los Alerces,Portada Centro,PN,PATAGONIA,2018m11,11,2018,COBRA,0,0,0,0,0,0,0,0,0
Los Alerces,Portada Norte,PN,PATAGONIA,2018m11,11,2018,COBRA,1119,1902,72,75,0,78,262,3508,2389
Los Alerces,Portada Sur,PN,PATAGONIA,2018m11,11,2018,COBRA,0,0,0,0,0,0,0,0,0
Los Alerces,Villa Futalaufquen,PN,PATAGONIA,2018m11,11,2018,NO COBRA,845,894,52,13,478,379,96,2757,1912
Los Glaciares,El Chaltén,PN,PATAGONIA,2018m11,11,2018,NO COBRA,16053,5592,0,0,0,0,0,21645,5592
Los Glaciares,Puerto Bandera,PN,PATAGONIA,2018m11,11,2018,COBRA,13546,3467,9,3143,160,0,252,20577,7031
Los Glaciares,Puerto La Cruz,PN,PATAGONIA,2018m11,11,2018,NO COBRA,0,0,0,0,0,0,0,0,0
Los Glaciares,Puerto La Soledad,PN,PATAGONIA,2018m11,11,2018,COBRA,3472,124,0,200,0,0,1083,4879,1407
Los Glaciares,Puerto Lago Argentino,PN,PATAGONIA,2018m11,11,2018,COBRA,0,0,0,0,0,0,0,0,0
Los Glaciares,Río Mitre,PN,PATAGONIA,2018m11,11,2018,COBRA,70313,9708,2418,1529,720,9779,964,95431,25118
Monte León,Única,PN,PATAGONIA,2018m11,11,2018,NO COBRA,0,0,0,0,0,0,0,0,0
Nahuel Huapi,Lago Mascardi,PN,PATAGONIA,2018m11,11,2018,COBRA,3564,2975,128,1446,399,0,32,8544,4980
Nahuel Huapi,Puerto Pañuelo,PN,PATAGONIA,2018m11,11,2018,COBRA,6922,5760,365,7817,724,0,376,21964,15042
Nahuel Huapi,Quetrihué,PN,PATAGONIA,2018m11,11,2018,COBRA,641,1842,778,1001,527,0,121,4910,4269
Nahuel Huapi,Río Limay,PN,PATAGONIA,2018m11,11,2018,COBRA,0,0,0,0,0,0,0,0,0
Patagonia,Única,PN,PATAGONIA,2018m11,11,2018,NO COBRA,0,0,0,0,0,0,0,0,0
Perito Moreno,Única,PN,PATAGONIA,2018m11,11,2018,NO COBRA,74,32,9,15,45,0,0,175,101
Tierra del Fuego,Ruta Nacional 3,PN,PATAGONIA,2018m11,11,2018,COBRA,19297,3742,5140,0,460,3768,5285,37692,18395
Tierra del Fuego,Tren del Fin del Mundo,PN,PATAGONIA,2018m11,11,2018,COBRA,7874,3492,256,0,168,2634,842,15266,7392
Ciervo de los Pantanos,Única,PN,CENTRO,2018m12,12,2018,NO COBRA,0,0,0,0,0,0,0,0,0
El Leoncito,Única,PN,CENTRO,2018m12,12,2018,NO COBRA,207,527,636,144,0,0,0,1514,1307
El Palmar,Única,PN,CENTRO,2018m12,12,2018,COBRA,82,3041,1114,769,1081,891,1272,8250,8168
Iberá,Cambyretá,PN,CENTRO,2018m12,12,2018,NO COBRA,85,134,44,231,0,0,56,550,465
Iberá,San Nicolás,PN,CENTRO,2018m12,12,2018,NO COBRA,49,76,60,84,16,0,15,300,251
Mburucuyá,Única,PN,CENTRO,2018m12,12,2018,NO COBRA,11,63,81,132,0,1,218,506,495
Pre Delta,Única,PN,CENTRO,2018m12,12,2018,NO COBRA,28,1259,1888,2796,1,47,995,7014,6986
Quebrada del Condorito,Única,PN,CENTRO,2018m12,12,2018,NO COBRA,212,639,486,125,0,0,0,1462,1250
San Guillermo,Única,PN,CENTRO,2018m12,12,2018,NO COBRA,0,0,0,0,0,0,0,0,0
Sierra de las Quijadas,Única,PN,CENTRO,2018m12,12,2018,COBRA,122,673,28,0,3,33,76,935,813
Talampaya,Única,PN,CENTRO,2018m12,12,2018,COBRA,702,861,55,0,171,692,149,2630,1928
Chaco,Única,PN,NEA,2018m12,12,2018,NO COBRA,2,53,189,122,41,0,150,557,555
Colonia Benítez,Única,RNEd,NEA,2018m12,12,2018,NO COBRA,0,44,10,9,64,0,0,127,127
El Impenetrable,Única,PN,NEA,2018m12,12,2018,NO COBRA,0,54,0,2,1,0,0,57,57
Formosa,Única,RNat,NEA,2018m12,12,2018,NO COBRA,0,1,0,12,2,0,2,17,17
Iguazú,Única,PN,NEA,2018m12,12,2018,COBRA,106287,48488,4941,3877,1261,7102,11688,183644,77357
Río Pilcomayo,Estero Poi,PN,NEA,2018m12,12,2018,NO COBRA,3,14,31,30,44,0,19,141,138
Río Pilcomayo,Laguna Blanca,PN,NEA,2018m12,12,2018,NO COBRA,10,79,284,2381,0,0,499,3253,3243
Aconquija,Única,PN,NOA,2018m12,12,2018,NO COBRA,0,0,0,0,0,0,0,0,0
Baritú,Única,PN,NOA,2018m12,12,2018,NO COBRA,0,0,0,0,0,0,0,0,0
Calilegua,Única,PN,NOA,2018m12,12,2018,NO COBRA,141,255,179,479,166,0,337,1557,1416
Copo,Guayacán,PN,NOA,2018m12,12,2018,NO COBRA,0,0,0,0,0,0,0,0,0
Copo,Portada,PN,NOA,2018m12,12,2018,NO COBRA,0,0,0,0,0,0,0,0,0
El Rey,Única,PN,NOA,2018m12,12,2018,NO COBRA,3,1,2,0,0,0,2,8,5
Laguna de los Pozuelos,Única,MN,NOA,2018m12,12,2018,NO COBRA,53,30,25,19,1,0,50,178,125
Los Cardones,Recta del Tín Tín,PN,NOA,2018m12,12,2018,NO COBRA,568,6072,531,351,0,4163,121,11806,11238
Los Cardones,Valle Encantado,PN,NOA,2018m12,12,2018,NO COBRA,0,0,0,0,0,0,0,0,0
Nogalar de los Toldos,Única,RNac,NOA,2018m12,12,2018,NO COBRA,84,0,26,24,0,0,0,134,50
Pizarro,Única,RNac,NOA,2018m12,12,2018,NO COBRA,0,0,0,0,0,0,0,0,0
Bosques Petrificados,Única,PN,PATAGONIA,2018m12,12,2018,NO COBRA,200,226,24,20,3,3,66,542,342
Lago Puelo,Única,PN,PATAGONIA,2018m12,12,2018,COBRA,709,6635,1707,30666,670,1173,1238,42798,42089
Laguna Blanca,Única,PN,PATAGONIA,2018m12,12,2018,NO COBRA,23,86,44,13,41,0,36,243,220
Lanín,Hua Hum,PN,PATAGONIA,2018m12,12,2018,NO COBRA,0,0,0,0,0,0,0,0,0
Lanín,Lago Huechulaufquen,PN,PATAGONIA,2018m12,12,2018,COBRA,636,1643,537,0,470,1112,93,4491,3855
Lanín,Muelle Lago Lácar,PN,PATAGONIA,2018m12,12,2018,COBRA,220,1159,358,0,130,524,91,2482,2262
Lanín,Quila Quina,PN,PATAGONIA,2018m12,12,2018,COBRA,88,1650,649,0,234,568,128,3317,3229
Lanín,Ruka Choroy,PN,PATAGONIA,2018m12,12,2018,NO COBRA,0,0,0,0,0,0,0,0,0
Lanín,Volcán Lanín,PN,PATAGONIA,2018m12,12,2018,NO COBRA,0,0,0,0,0,0,0,0,0
Lanín,Área Tromen,PN,PATAGONIA,2018m12,12,2018,NO COBRA,0,0,0,0,0,0,0,0,0
Lanín,Ñorkinko,PN,PATAGONIA,2018m12,12,2018,NO COBRA,0,0,0,0,0,0,0,0,0
Lihué Calel,Única,PN,PATAGONIA,2018m12,12,2018,NO COBRA,85,186,96,35,29,15,88,534,449
Los Alerces,Portada Centro,PN,PATAGONIA,2018m12,12,2018,COBRA,471,2364,1999,13144,202,411,2814,21405,20934
Los Alerces,Portada Norte,PN,PATAGONIA,2018m12,12,2018,COBRA,1185,2531,75,41,573,357,137,4899,3714
Los Alerces,Portada Sur,PN,PATAGONIA,2018m12,12,2018,COBRA,15,110,90,563,1,42,142,963,948
Los Alerces,Villa Futalaufquen,PN,PATAGONIA,2018m12,12,2018,NO COBRA,0,0,0,0,0,0,0,0,0
Los Glaciares,El Chaltén,PN,PATAGONIA,2018m12,12,2018,NO COBRA,18129,5900,0,0,0,0,0,24029,5900
Los Glaciares,Puerto Bandera,PN,PATAGONIA,2018m12,12,2018,COBRA,12088,2706,86,1668,334,0,724,17606,5518
Los Glaciares,Puerto La Cruz,PN,PATAGONIA,2018m12,12,2018,NO COBRA,0,0,0,0,0,0,0,0,0
Los Glaciares,Puerto La Soledad,PN,PATAGONIA,2018m12,12,2018,COBRA,2045,19,0,157,0,0,0,2221,176
Los Glaciares,Puerto Lago Argentino,PN,PATAGONIA,2018m12,12,2018,COBRA,0,0,0,0,0,0,0,0,0
Los Glaciares,Río Mitre,PN,PATAGONIA,2018m12,12,2018,COBRA,44588,10215,3115,2489,2148,7114,2979,72648,28060
Monte León,Única,PN,PATAGONIA,2018m12,12,2018,NO COBRA,216,219,91,120,0,142,0,788,572
Nahuel Huapi,Lago Mascardi,PN,PATAGONIA,2018m12,12,2018,COBRA,2125,4723,324,825,818,0,25,8840,6715
Nahuel Huapi,Puerto Pañuelo,PN,PATAGONIA,2018m12,12,2018,COBRA,9238,9298,1624,5650,5505,0,1043,32358,23120
Nahuel Huapi,Quetrihué,PN,PATAGONIA,2018m12,12,2018,COBRA,1002,4787,1068,2310,882,0,562,10611,9609
Nahuel Huapi,Río Limay,PN,PATAGONIA,2018m12,12,2018,COBRA,0,0,0,0,0,0,0,0,0
Patagonia,Única,PN,PATAGONIA,2018m12,12,2018,NO COBRA,0,0,0,0,0,0,0,0,0
Perito Moreno,Única,PN,PATAGONIA,2018m12,12,2018,NO COBRA,51,79,8,12,0,0,33,183,132
Tierra del Fuego,Ruta Nacional 3,PN,PATAGONIA,2018m12,12,2018,COBRA,29843,4030,6517,0,787,3031,3936,48144,18301
Tierra del Fuego,Tren del Fin del Mundo,PN,PATAGONIA,2018m12,12,2018,COBRA,13977,3782,429,0,123,2411,1200,21922,7945
Ciervo de los Pantanos,Única,PN,CENTRO,2019m1,1,2019,NO COBRA,0,0,0,0,0,0,0,0,0
El Leoncito,Única,PN,CENTRO,2019m1,1,2019,NO COBRA,187,1892,1884,375,0,0,0,4338,4151
El Palmar,Única,PN,CENTRO,2019m1,1,2019,COBRA,182,5469,1983,490,1201,2239,1176,12740,12558
Iberá,Cambyretá,PN,CENTRO,2019m1,1,2019,NO COBRA,129,509,32,222,11,0,70,973,844
Iberá,San Nicolás,PN,CENTRO,2019m1,1,2019,NO COBRA,12,26,44,25,0,0,27,134,122
Mburucuyá,Única,PN,CENTRO,2019m1,1,2019,NO COBRA,2,24,37,42,0,1,81,187,185
Pre Delta,Única,PN,CENTRO,2019m1,1,2019,NO COBRA,53,1366,2186,2547,147,23,1021,7343,7290
Quebrada del Condorito,Única,PN,CENTRO,2019m1,1,2019,NO COBRA,235,1717,1276,119,0,0,0,3347,3112
San Guillermo,Única,PN,CENTRO,2019m1,1,2019,NO COBRA,0,0,0,0,0,0,0,0,0
Sierra de las Quijadas,Única,PN,CENTRO,2019m1,1,2019,COBRA,146,3464,301,0,45,59,716,4731,4585
Talampaya,Única,PN,CENTRO,2019m1,1,2019,COBRA,516,2863,57,15,657,479,671,5258,4742
Chaco,Única,PN,NEA,2019m1,1,2019,NO COBRA,2,187,157,242,51,0,97,736,734
Colonia Benítez,Única,RNEd,NEA,2019m1,1,2019,NO COBRA,2,4,27,15,0,0,0,48,46
El Impenetrable,Única,PN,NEA,2019m1,1,2019,NO COBRA,0,9,4,1,0,0,0,14,14
Formosa,Única,RNat,NEA,2019m1,1,2019,NO COBRA,0,1,0,0,0,0,0,1,1
Iguazú,Única,PN,NEA,2019m1,1,2019,COBRA,123486,91194,9081,3564,0,9200,36858,273383,149897
Río Pilcomayo,Estero Poi,PN,NEA,2019m1,1,2019,NO COBRA,15,106,153,28,0,2,104,408,393
Río Pilcomayo,Laguna Blanca,PN,NEA,2019m1,1,2019,NO COBRA,49,121,598,2503,0,0,988,4259,4210
Aconquija,Única,PN,NOA,2019m1,1,2019,NO COBRA,0,4,12,0,0,0,0,16,16
Baritú,Única,PN,NOA,2019m1,1,2019,NO COBRA,0,0,0,0,0,0,0,0,0
Calilegua,Única,PN,NOA,2019m1,1,2019,NO COBRA,151,844,348,475,0,0,374,2192,2041
Copo,Guayacán,PN,NOA,2019m1,1,2019,NO COBRA,0,0,0,0,0,0,0,0,0
Copo,Portada,PN,NOA,2019m1,1,2019,NO COBRA,0,0,0,0,0,0,0,0,0
El Rey,Única,PN,NOA,2019m1,1,2019,NO COBRA,0,0,0,0,0,0,0,0,0
Laguna de los Pozuelos,Única,MN,NOA,2019m1,1,2019,NO COBRA,64,96,99,36,6,8,31,340,276
Los Cardones,Recta del Tín Tín,PN,NOA,2019m1,1,2019,NO COBRA,388,3493,369,71,0,3036,109,7466,7078
Los Cardones,Valle Encantado,PN,NOA,2019m1,1,2019,NO COBRA,0,0,0,0,0,0,0,0,0
Nogalar de los Toldos,Única,RNac,NOA,2019m1,1,2019,NO COBRA,4,10,2,10,0,0,9,35,31
Pizarro,Única,RNac,NOA,2019m1,1,2019,NO COBRA,0,0,0,0,0,0,0,0,0
Bosques Petrificados,Única,PN,PATAGONIA,2019m1,1,2019,NO COBRA,258,1075,80,41,3,20,244,1721,1463
Lago Puelo,Única,PN,PATAGONIA,2019m1,1,2019,COBRA,448,17334,2962,29148,4102,2600,2157,58751,58303
Laguna Blanca,Única,PN,PATAGONIA,2019m1,1,2019,NO COBRA,39,297,133,55,0,0,129,653,614
Lanín,Hua Hum,PN,PATAGONIA,2019m1,1,2019,NO COBRA,0,0,0,0,0,0,0,0,0
Lanín,Lago Huechulaufquen,PN,PATAGONIA,2019m1,1,2019,COBRA,629,9652,2123,3997,3776,2375,1783,24335,23706
Lanín,Muelle Lago Lácar,PN,PATAGONIA,2019m1,1,2019,COBRA,633,4261,2149,879,1634,921,2214,12691,12058
Lanín,Quila Quina,PN,PATAGONIA,2019m1,1,2019,COBRA,1160,10022,4415,2114,4233,1259,3688,26891,25731
Lanín,Ruka Choroy,PN,PATAGONIA,2019m1,1,2019,NO COBRA,0,0,0,0,0,0,0,0,0
Lanín,Volcán Lanín,PN,PATAGONIA,2019m1,1,2019,NO COBRA,0,0,0,0,0,0,0,0,0
Lanín,Área Tromen,PN,PATAGONIA,2019m1,1,2019,NO COBRA,0,0,0,0,0,0,0,0,0
Lanín,Ñorkinko,PN,PATAGONIA,2019m1,1,2019,NO COBRA,0,0,0,0,0,0,0,0,0
Lihué Calel,Única,PN,PATAGONIA,2019m1,1,2019,NO COBRA,23,663,145,59,3,16,219,1128,1105
Los Alerces,Portada Centro,PN,PATAGONIA,2019m1,1,2019,COBRA,951,6914,1163,19026,1136,1670,2913,33773,32822
Los Alerces,Portada Norte,PN,PATAGONIA,2019m1,1,2019,COBRA,728,3170,1442,1032,851,447,527,8197,7469
Los Alerces,Portada Sur,PN,PATAGONIA,2019m1,1,2019,COBRA,58,1428,423,3275,270,691,1222,7367,7309
Los Alerces,Villa Futalaufquen,PN,PATAGONIA,2019m1,1,2019,NO COBRA,0,0,0,0,0,0,0,0,0
Los Glaciares,El Chaltén,PN,PATAGONIA,2019m1,1,2019,NO COBRA,16989,11323,0,0,0,0,0,28312,11323
Los Glaciares,Puerto Bandera,PN,PATAGONIA,2019m1,1,2019,COBRA,14706,6706,223,2403,1327,0,1085,26450,11744
Los Glaciares,Puerto La Cruz,PN,PATAGONIA,2019m1,1,2019,NO COBRA,0,0,0,0,0,0,0,0,0
Los Glaciares,Puerto La Soledad,PN,PATAGONIA,2019m1,1,2019,COBRA,5469,115,0,104,0,0,181,5869,400
Los Glaciares,Puerto Lago Argentino,PN,PATAGONIA,2019m1,1,2019,COBRA,0,0,0,0,0,0,0,0,0
Los Glaciares,Río Mitre,PN,PATAGONIA,2019m1,1,2019,COBRA,55914,22014,4198,7727,4974,7527,5910,108264,52350
Monte León,Única,PN,PATAGONIA,2019m1,1,2019,NO COBRA,213,330,61,103,0,0,194,901,688
Nahuel Huapi,Lago Mascardi,PN,PATAGONIA,2019m1,1,2019,COBRA,4550,20988,1202,9319,4884,0,383,41326,36776
Nahuel Huapi,Puerto Pañuelo,PN,PATAGONIA,2019m1,1,2019,COBRA,8738,26604,950,7774,7201,0,2256,53523,44785
Nahuel Huapi,Quetrihué,PN,PATAGONIA,2019m1,1,2019,COBRA,1272,12878,1940,3441,6130,0,1150,26811,25539
Nahuel Huapi,Río Limay,PN,PATAGONIA,2019m1,1,2019,COBRA,0,0,0,0,0,0,0,0,0
Patagonia,Única,PN,PATAGONIA,2019m1,1,2019,NO COBRA,0,0,0,0,0,0,0,0,0
Perito Moreno,Única,PN,PATAGONIA,2019m1,1,2019,NO COBRA,195,254,29,21,0,0,69,568,373
Tierra del Fuego,Ruta Nacional 3,PN,PATAGONIA,2019m1,1,2019,COBRA,43282,9203,7705,0,2313,3264,7824,73591,30309
Tierra del Fuego,Tren del Fin del Mundo,PN,PATAGONIA,2019m1,1,2019,COBRA,9680,12500,567,0,770,3361,1944,28822,19142
Ciervo de los Pantanos,Única,PN,CENTRO,2019m2,2,2019,NO COBRA,0,0,0,0,0,0,0,0,0
El Leoncito,Única,PN,CENTRO,2019m2,2,2019,NO COBRA,161,1055,1313,244,0,0,0,2773,2612
El Palmar,Única,PN,CENTRO,2019m2,2,2019,COBRA,118,9090,3350,582,868,3004,2030,19042,18924
Iberá,Cambyretá,PN,CENTRO,2019m2,2,2019,NO COBRA,84,312,35,275,12,18,170,906,822
Iberá,San Nicolás,PN,CENTRO,2019m2,2,2019,NO COBRA,16,22,45,35,0,0,13,131,115
Mburucuyá,Única,PN,CENTRO,2019m2,2,2019,NO COBRA,1,133,144,141,0,1,169,589,588
Pre Delta,Única,PN,CENTRO,2019m2,2,2019,NO COBRA,0,0,0,0,0,0,0,0,0
Quebrada del Condorito,Única,PN,CENTRO,2019m2,2,2019,NO COBRA,274,1346,1043,148,0,0,0,2811,2537
San Guillermo,Única,PN,CENTRO,2019m2,2,2019,NO COBRA,0,0,0,0,0,0,0,0,0
Sierra de las Quijadas,Única,PN,CENTRO,2019m2,2,2019,COBRA,137,2105,36,55,64,275,799,3471,3334
Talampaya,Única,PN,CENTRO,2019m2,2,2019,COBRA,704,2284,83,0,176,381,321,3949,3245
Chaco,Única,PN,NEA,2019m2,2,2019,NO COBRA,11,79,190,102,2,0,97,481,470
Colonia Benítez,Única,RNEd,NEA,2019m2,2,2019,NO COBRA,0,0,0,0,0,0,0,0,0
El Impenetrable,Única,PN,NEA,2019m2,2,2019,NO COBRA,0,22,3,1,0,0,0,26,26
Formosa,Única,RNat,NEA,2019m2,2,2019,NO COBRA,0,0,0,7,0,0,0,7,7
Iguazú,Única,PN,NEA,2019m2,2,2019,COBRA,112199,74872,9940,3124,0,11210,20681,232026,119827
Río Pilcomayo,Estero Poi,PN,NEA,2019m2,2,2019,NO COBRA,10,54,52,54,20,0,70,260,250
Río Pilcomayo,Laguna Blanca,PN,NEA,2019m2,2,2019,NO COBRA,17,88,247,457,18,0,175,1002,985
Aconquija,Única,PN,NOA,2019m2,2,2019,NO COBRA,0,0,0,0,0,0,0,0,0
Baritú,Única,PN,NOA,2019m2,2,2019,NO COBRA,0,0,0,0,0,0,0,0,0
Calilegua,Única,PN,NOA,2019m2,2,2019,NO COBRA,184,817,321,440,0,0,371,2133,1949
Copo,Guayacán,PN,NOA,2019m2,2,2019,NO COBRA,0,0,0,0,0,0,0,0,0
Copo,Portada,PN,NOA,2019m2,2,2019,NO COBRA,0,0,0,0,0,0,0,0,0
El Rey,Única,PN,NOA,2019m2,2,2019,NO COBRA,0,0,0,0,0,0,0,0,0
Laguna de los Pozuelos,Única,MN,NOA,2019m2,2,2019,NO COBRA,66,57,49,20,0,0,11,203,137
Los Cardones,Recta del Tín Tín,PN,NOA,2019m2,2,2019,NO COBRA,3175,5284,396,31,0,5000,78,13964,10789
Los Cardones,Valle Encantado,PN,NOA,2019m2,2,2019,NO COBRA,0,0,0,0,0,0,0,0,0
Nogalar de los Toldos,Única,RNac,NOA,2019m2,2,2019,NO COBRA,0,0,0,0,0,0,0,0,0
Pizarro,Única,RNac,NOA,2019m2,2,2019,NO COBRA,0,0,0,0,0,0,0,0,0
Bosques Petrificados,Única,PN,PATAGONIA,2019m2,2,2019,NO COBRA,192,241,29,10,0,36,50,558,366
Lago Puelo,Única,PN,PATAGONIA,2019m2,2,2019,COBRA,2327,10381,2323,33585,1461,2923,3508,56508,54181
Laguna Blanca,Única,PN,PATAGONIA,2019m2,2,2019,NO COBRA,20,104,63,53,0,0,43,283,263
Lanín,Hua Hum,PN,PATAGONIA,2019m2,2,2019,NO COBRA,0,0,0,0,0,0,0,0,0
Lanín,Lago Huechulaufquen,PN,PATAGONIA,2019m2,2,2019,COBRA,377,5007,1352,631,1444,1363,363,10537,10160
Lanín,Muelle Lago Lácar,PN,PATAGONIA,2019m2,2,2019,COBRA,563,2588,2115,321,1317,1119,1474,9497,8934
Lanín,Quila Quina,PN,PATAGONIA,2019m2,2,2019,COBRA,618,6490,2381,393,2783,661,1739,15065,14447
Lanín,Ruka Choroy,PN,PATAGONIA,2019m2,2,2019,NO COBRA,0,0,0,0,0,0,0,0,0
Lanín,Volcán Lanín,PN,PATAGONIA,2019m2,2,2019,NO COBRA,0,0,0,0,0,0,0,0,0
Lanín,Área Tromen,PN,PATAGONIA,2019m2,2,2019,NO COBRA,0,0,0,0,0,0,0,0,0
Lanín,Ñorkinko,PN,PATAGONIA,2019m2,2,2019,NO COBRA,0,0,0,0,0,0,0,0,0
Lihué Calel,Única,PN,PATAGONIA,2019m2,2,2019,NO COBRA,15,305,57,62,0,11,131,581,566
Los Alerces,Portada Centro,PN,PATAGONIA,2019m2,2,2019,COBRA,1277,3053,678,22842,444,782,3664,32740,31463
Los Alerces,Portada Norte,PN,PATAGONIA,2019m2,2,2019,COBRA,568,1508,850,463,254,421,253,4317,3749
Los Alerces,Portada Sur,PN,PATAGONIA,2019m2,2,2019,COBRA,148,1293,445,6612,152,352,1708,10710,10562
Los Alerces,Villa Futalaufquen,PN,PATAGONIA,2019m2,2,2019,NO COBRA,0,0,0,0,0,0,0,0,0
Los Glaciares,El Chaltén,PN,PATAGONIA,2019m2,2,2019,NO COBRA,17341,8478,0,0,0,0,0,25819,8478
Los Glaciares,Puerto Bandera,PN,PATAGONIA,2019m2,2,2019,COBRA,7931,6829,113,4155,649,0,739,20416,12485
Los Glaciares,Puerto La Cruz,PN,PATAGONIA,2019m2,2,2019,NO COBRA,0,0,0,0,0,0,0,0,0
Los Glaciares,Puerto La Soledad,PN,PATAGONIA,2019m2,2,2019,COBRA,3637,156,0,169,0,0,0,3962,325
Los Glaciares,Puerto Lago Argentino,PN,PATAGONIA,2019m2,2,2019,COBRA,0,0,0,0,0,0,0,0,0
Los Glaciares,Río Mitre,PN,PATAGONIA,2019m2,2,2019,COBRA,56587,14207,8520,7118,2460,4080,5801,98773,42186
Monte León,Única,PN,PATAGONIA,2019m2,2,2019,NO COBRA,0,363,0,407,0,0,126,896,896
Nahuel Huapi,Lago Mascardi,PN,PATAGONIA,2019m2,2,2019,COBRA,3663,7762,432,5904,2112,243,258,20374,16711
Nahuel Huapi,Puerto Pañuelo,PN,PATAGONIA,2019m2,2,2019,COBRA,7655,20544,552,6899,3121,0,2672,41443,33788
Nahuel Huapi,Quetrihué,PN,PATAGONIA,2019m2,2,2019,COBRA,2348,7952,2000,663,2224,846,2128,18161,15813
Nahuel Huapi,Río Limay,PN,PATAGONIA,2019m2,2,2019,COBRA,0,0,0,0,0,0,0,0,0
Patagonia,Única,PN,PATAGONIA,2019m2,2,2019,NO COBRA,0,0,0,0,0,0,0,0,0
Perito Moreno,Única,PN,PATAGONIA,2019m2,2,2019,NO COBRA,169,112,77,4,0,0,28,390,221
Tierra del Fuego,Ruta Nacional 3,PN,PATAGONIA,2019m2,2,2019,COBRA,47781,8861,10411,0,1180,2771,5205,76209,28428
Tierra del Fuego,Tren del Fin del Mundo,PN,PATAGONIA,2019m2,2,2019,COBRA,15450,5842,355,0,380,3442,1419,26888,11438
Ciervo de los Pantanos,Única,PN,CENTRO,2019m3,3,2019,NO COBRA,0,0,0,0,0,0,0,0,0
El Leoncito,Única,PN,CENTRO,2019m3,3,2019,NO COBRA,156,1120,1455,98,0,0,0,2829,2673
El Palmar,Única,PN,CENTRO,2019m3,3,2019,COBRA,103,6991,2669,482,864,5044,1086,17239,17136
Iberá,Cambyretá,PN,CENTRO,2019m3,3,2019,NO COBRA,153,269,17,205,0,0,118,762,609
Iberá,San Nicolás,PN,CENTRO,2019m3,3,2019,NO COBRA,31,150,45,116,8,0,27,377,346
Mburucuyá,Única,PN,CENTRO,2019m3,3,2019,NO COBRA,11,174,245,108,0,3,185,726,715
Pre Delta,Única,PN,CENTRO,2019m3,3,2019,NO COBRA,50,2180,3088,2797,179,155,2974,11423,11373
Quebrada del Condorito,Única,PN,CENTRO,2019m3,3,2019,NO COBRA,253,1008,1255,184,0,0,0,2700,2447
San Guillermo,Única,PN,CENTRO,2019m3,3,2019,NO COBRA,0,0,0,0,0,0,0,0,0
Sierra de las Quijadas,Única,PN,CENTRO,2019m3,3,2019,COBRA,86,1216,147,31,22,158,331,1991,1905
Talampaya,Única,PN,CENTRO,2019m3,3,2019,COBRA,889,3264,110,0,279,1598,204,6344,5455
Chaco,Única,PN,NEA,2019m3,3,2019,NO COBRA,23,45,95,137,0,0,0,300,277
Colonia Benítez,Única,RNEd,NEA,2019m3,3,2019,NO COBRA,0,6,0,3,86,0,0,95,95
El Impenetrable,Única,PN,NEA,2019m3,3,2019,NO COBRA,0,17,0,4,4,0,0,25,25
Formosa,Única,RNat,NEA,2019m3,3,2019,NO COBRA,0,2,0,0,1,0,0,3,3
Iguazú,Única,PN,NEA,2019m3,3,2019,COBRA,84045,71953,3004,464,318,12092,12683,184559,100514
Río Pilcomayo,Estero Poi,PN,NEA,2019m3,3,2019,NO COBRA,9,35,23,15,0,0,1,83,74
Río Pilcomayo,Laguna Blanca,PN,NEA,2019m3,3,2019,NO COBRA,39,4,157,294,0,0,73,567,528
Aconquija,Única,PN,NOA,2019m3,3,2019,NO COBRA,0,0,0,0,0,0,0,0,0
Baritú,Única,PN,NOA,2019m3,3,2019,NO COBRA,2,2,0,0,0,0,0,4,2
Calilegua,Única,PN,NOA,2019m3,3,2019,NO COBRA,180,580,149,444,34,0,116,1503,1323
Copo,Guayacán,PN,NOA,2019m3,3,2019,NO COBRA,0,0,0,0,0,0,0,0,0
Copo,Portada,PN,NOA,2019m3,3,2019,NO COBRA,0,0,0,0,0,0,0,0,0
El Rey,Única,PN,NOA,2019m3,3,2019,NO COBRA,0,0,0,0,0,0,0,0,0
Laguna de los Pozuelos,Única,MN,NOA,2019m3,3,2019,NO COBRA,53,138,39,10,0,0,11,251,198
Los Cardones,Recta del Tín Tín,PN,NOA,2019m3,3,2019,NO COBRA,1823,4119,576,367,0,6480,198,13563,11740
Los Cardones,Valle Encantado,PN,NOA,2019m3,3,2019,NO COBRA,0,0,0,0,0,0,0,0,0
Nogalar de los Toldos,Única,RNac,NOA,2019m3,3,2019,NO COBRA,0,0,0,0,0,0,0,0,0
Pizarro,Única,RNac,NOA,2019m3,3,2019,NO COBRA,0,0,0,0,0,0,0,0,0
Bosques Petrificados,Única,PN,PATAGONIA,2019m3,3,2019,NO COBRA,115,174,80,7,9,63,59,507,392
Lago Puelo,Única,PN,PATAGONIA,2019m3,3,2019,COBRA,1087,15776,2854,16617,931,3392,2068,42725,41638
Laguna Blanca,Única,PN,PATAGONIA,2019m3,3,2019,NO COBRA,8,201,60,64,0,0,47,380,372
Lanín,Hua Hum,PN,PATAGONIA,2019m3,3,2019,NO COBRA,0,0,0,0,0,0,0,0,0
Lanín,Lago Huechulaufquen,PN,PATAGONIA,2019m3,3,2019,COBRA,372,3115,1243,249,308,880,935,7102,6730
Lanín,Muelle Lago Lácar,PN,PATAGONIA,2019m3,3,2019,COBRA,445,1463,328,418,111,355,393,3513,3068
Lanín,Quila Quina,PN,PATAGONIA,2019m3,3,2019,COBRA,248,2613,765,105,219,186,594,4730,4482
Lanín,Ruka Choroy,PN,PATAGONIA,2019m3,3,2019,NO COBRA,0,0,0,0,0,0,0,0,0
Lanín,Volcán Lanín,PN,PATAGONIA,2019m3,3,2019,NO COBRA,0,0,0,0,0,0,0,0,0
Lanín,Área Tromen,PN,PATAGONIA,2019m3,3,2019,NO COBRA,0,0,0,0,0,0,0,0,0
Lanín,Ñorkinko,PN,PATAGONIA,2019m3,3,2019,NO COBRA,0,0,0,0,0,0,0,0,0
Lihué Calel,Única,PN,PATAGONIA,2019m3,3,2019,NO COBRA,12,177,210,34,48,36,77,594,582
Los Alerces,Portada Centro,PN,PATAGONIA,2019m3,3,2019,COBRA,552,1710,945,5191,316,1249,546,10509,9957
Los Alerces,Portada Norte,PN,PATAGONIA,2019m3,3,2019,COBRA,167,732,741,936,80,235,82,2973,2806
Los Alerces,Portada Sur,PN,PATAGONIA,2019m3,3,2019,COBRA,75,558,409,8566,63,728,2272,12671,12596
Los Alerces,Villa Futalaufquen,PN,PATAGONIA,2019m3,3,2019,NO COBRA,0,0,0,0,0,0,0,0,0
Los Glaciares,El Chaltén,PN,PATAGONIA,2019m3,3,2019,NO COBRA,16813,8235,0,0,0,0,0,25048,8235
Los Glaciares,Puerto Bandera,PN,PATAGONIA,2019m3,3,2019,COBRA,7019,3036,62,3566,384,0,199,14266,7247
Los Glaciares,Puerto La Cruz,PN,PATAGONIA,2019m3,3,2019,NO COBRA,0,0,0,0,0,0,0,0,0
Los Glaciares,Puerto La Soledad,PN,PATAGONIA,2019m3,3,2019,COBRA,2855,156,0,169,0,0,0,3180,325
Los Glaciares,Puerto Lago Argentino,PN,PATAGONIA,2019m3,3,2019,COBRA,0,0,0,0,0,0,0,0,0
Los Glaciares,Río Mitre,PN,PATAGONIA,2019m3,3,2019,COBRA,54663,13187,2404,5598,1323,3574,2457,83206,28543
Monte León,Única,PN,PATAGONIA,2019m3,3,2019,NO COBRA,97,131,165,85,0,0,66,544,447
Nahuel Huapi,Lago Mascardi,PN,PATAGONIA,2019m3,3,2019,COBRA,2738,5834,534,5986,1333,800,2323,19548,16810
Nahuel Huapi,Puerto Pañuelo,PN,PATAGONIA,2019m3,3,2019,COBRA,6712,15971,1383,638,2739,5921,1154,34518,27806
Nahuel Huapi,Quetrihué,PN,PATAGONIA,2019m3,3,2019,COBRA,2365,9032,3412,729,2049,1145,1588,20320,17955
Nahuel Huapi,Río Limay,PN,PATAGONIA,2019m3,3,2019,COBRA,0,0,0,0,355,0,0,355,355
Patagonia,Única,PN,PATAGONIA,2019m3,3,2019,NO COBRA,0,0,0,0,0,0,0,0,0
Perito Moreno,Única,PN,PATAGONIA,2019m3,3,2019,NO COBRA,89,51,39,19,0,0,3,201,112
Tierra del Fuego,Ruta Nacional 3,PN,PATAGONIA,2019m3,3,2019,COBRA,19350,5082,7754,0,677,2793,5261,40917,21567
Tierra del Fuego,Tren del Fin del Mundo,PN,PATAGONIA,2019m3,3,2019,COBRA,9085,4763,312,0,360,4077,427,19024,9939
Ciervo de los Pantanos,Única,PN,CENTRO,2019m4,4,2019,NO COBRA,0,0,0,0,0,0,0,0,0
El Leoncito,Única,PN,CENTRO,2019m4,4,2019,NO COBRA,203,1378,1613,285,0,0,0,3479,3276
El Palmar,Única,PN,CENTRO,2019m4,4,2019,COBRA,274,8557,2721,716,1068,2723,1184,17243,16969
Iberá,Cambyretá,PN,CENTRO,2019m4,4,2019,NO COBRA,161,384,24,381,8,3,98,1059,898
Iberá,San Nicolás,PN,CENTRO,2019m4,4,2019,NO COBRA,57,252,205,160,52,14,49,789,732
Mburucuyá,Única,PN,CENTRO,2019m4,4,2019,NO COBRA,34,244,264,251,0,4,155,952,918
Pre Delta,Única,PN,CENTRO,2019m4,4,2019,NO COBRA,82,2987,3116,2874,212,354,2397,12022,11940
Quebrada del Condorito,Única,PN,CENTRO,2019m4,4,2019,NO COBRA,361,830,1971,468,0,0,0,3630,3269
San Guillermo,Única,PN,CENTRO,2019m4,4,2019,NO COBRA,0,0,0,0,0,0,0,0,0
Sierra de las Quijadas,Única,PN,CENTRO,2019m4,4,2019,COBRA,91,2096,277,21,11,264,328,3088,2997
Talampaya,Única,PN,CENTRO,2019m4,4,2019,COBRA,1082,5405,262,0,289,2973,368,10379,9297
Chaco,Única,PN,NEA,2019m4,4,2019,NO COBRA,21,56,245,122,0,0,28,472,451
Colonia Benítez,Única,RNEd,NEA,2019m4,4,2019,NO COBRA,4,29,17,2,117,3,0,172,168
El Impenetrable,Única,PN,NEA,2019m4,4,2019,NO COBRA,1,6,2,0,0,0,0,9,8
Formosa,Única,RNat,NEA,2019m4,4,2019,NO COBRA,0,1,0,0,0,0,0,1,1
Iguazú,Única,PN,NEA,2019m4,4,2019,COBRA,102633,55100,1844,1187,17605,11710,13656,203735,101102
Río Pilcomayo,Estero Poi,PN,NEA,2019m4,4,2019,NO COBRA,9,35,20,49,14,0,15,142,133
Río Pilcomayo,Laguna Blanca,PN,NEA,2019m4,4,2019,NO COBRA,28,155,101,137,0,2,151,574,546
Aconquija,Única,PN,NOA,2019m4,4,2019,NO COBRA,0,9,13,63,0,0,0,85,85
Baritú,Única,PN,NOA,2019m4,4,2019,NO COBRA,0,11,0,0,0,0,0,11,11
Calilegua,Única,PN,NOA,2019m4,4,2019,NO COBRA,107,883,79,449,27,0,179,1724,1617
Copo,Guayacán,PN,NOA,2019m4,4,2019,NO COBRA,0,0,0,0,0,0,0,0,0
Copo,Portada,PN,NOA,2019m4,4,2019,NO COBRA,0,0,0,0,0,0,0,0,0
El Rey,Única,PN,NOA,2019m4,4,2019,NO COBRA,0,0,0,0,0,0,0,0,0
Laguna de los Pozuelos,Única,MN,NOA,2019m4,4,2019,NO COBRA,57,56,41,14,0,0,14,182,125
Los Cardones,Recta del Tín Tín,PN,NOA,2019m4,4,2019,NO COBRA,474,8162,430,1131,0,4517,287,15001,14527
Los Cardones,Valle Encantado,PN,NOA,2019m4,4,2019,NO COBRA,0,0,0,0,0,0,0,0,0
Nogalar de los Toldos,Única,RNac,NOA,2019m4,4,2019,NO COBRA,41,17,21,11,0,2,15,107,66
Pizarro,Única,RNac,NOA,2019m4,4,2019,NO COBRA,0,0,0,0,0,0,0,0,0
Bosques Petrificados,Única,PN,PATAGONIA,2019m4,4,2019,NO COBRA,62,109,85,12,0,24,36,328,266
Lago Puelo,Única,PN,PATAGONIA,2019m4,4,2019,COBRA,595,7257,1707,8153,407,3775,1455,23349,22754
Laguna Blanca,Única,PN,PATAGONIA,2019m4,4,2019,NO COBRA,4,61,216,323,0,0,100,704,700
Lanín,Hua Hum,PN,PATAGONIA,2019m4,4,2019,NO COBRA,0,0,0,0,0,0,0,0,0
Lanín,Lago Huechulaufquen,PN,PATAGONIA,2019m4,4,2019,COBRA,323,1505,359,750,131,622,440,4130,3807
Lanín,Muelle Lago Lácar,PN,PATAGONIA,2019m4,4,2019,COBRA,271,1578,632,479,183,723,302,4168,3897
Lanín,Quila Quina,PN,PATAGONIA,2019m4,4,2019,COBRA,134,1257,545,492,312,267,224,3231,3097
Lanín,Ruka Choroy,PN,PATAGONIA,2019m4,4,2019,NO COBRA,0,0,0,0,0,0,0,0,0
Lanín,Volcán Lanín,PN,PATAGONIA,2019m4,4,2019,NO COBRA,0,0,0,0,0,0,0,0,0
Lanín,Área Tromen,PN,PATAGONIA,2019m4,4,2019,NO COBRA,0,0,0,0,0,0,0,0,0
Lanín,Ñorkinko,PN,PATAGONIA,2019m4,4,2019,NO COBRA,0,0,0,0,0,0,0,0,0
Lihué Calel,Única,PN,PATAGONIA,2019m4,4,2019,NO COBRA,25,181,282,69,52,22,103,734,709
Los Alerces,Portada Centro,PN,PATAGONIA,2019m4,4,2019,COBRA,356,673,1643,1978,79,546,224,5499,5143
Los Alerces,Portada Norte,PN,PATAGONIA,2019m4,4,2019,COBRA,64,184,177,201,65,137,46,874,810
Los Alerces,Portada Sur,PN,PATAGONIA,2019m4,4,2019,COBRA,19,407,214,4131,345,460,1777,7353,7334
Los Alerces,Villa Futalaufquen,PN,PATAGONIA,2019m4,4,2019,NO COBRA,0,0,0,0,0,0,0,0,0
Los Glaciares,El Chaltén,PN,PATAGONIA,2019m4,4,2019,NO COBRA,10093,6733,0,0,0,0,0,16826,6733
Los Glaciares,Puerto Bandera,PN,PATAGONIA,2019m4,4,2019,COBRA,4687,2917,35,2494,287,0,463,10883,6196
Los Glaciares,Puerto La Cruz,PN,PATAGONIA,2019m4,4,2019,NO COBRA,0,0,0,0,0,0,0,0,0
Los Glaciares,Puerto La Soledad,PN,PATAGONIA,2019m4,4,2019,COBRA,1101,174,0,106,0,0,0,1381,280
Los Glaciares,Puerto Lago Argentino,PN,PATAGONIA,2019m4,4,2019,COBRA,0,0,0,0,0,0,0,0,0
Los Glaciares,Río Mitre,PN,PATAGONIA,2019m4,4,2019,COBRA,22605,12506,1650,3173,1703,4762,1645,48044,25439
Monte León,Única,PN,PATAGONIA,2019m4,4,2019,NO COBRA,47,45,32,36,0,0,62,222,175
Nahuel Huapi,Lago Mascardi,PN,PATAGONIA,2019m4,4,2019,COBRA,2346,3661,91,2350,537,19,57,9061,6715
Nahuel Huapi,Puerto Pañuelo,PN,PATAGONIA,2019m4,4,2019,COBRA,6049,11217,927,1156,968,4581,1456,26354,20305
Nahuel Huapi,Quetrihué,PN,PATAGONIA,2019m4,4,2019,COBRA,738,2894,805,258,368,827,678,6568,5830
Nahuel Huapi,Río Limay,PN,PATAGONIA,2019m4,4,2019,COBRA,0,0,0,0,0,0,0,0,0
Patagonia,Única,PN,PATAGONIA,2019m4,4,2019,NO COBRA,0,0,0,0,0,0,0,0,0
Perito Moreno,Única,PN,PATAGONIA,2019m4,4,2019,NO COBRA,13,32,14,3,0,0,17,79,66
Tierra del Fuego,Ruta Nacional 3,PN,PATAGONIA,2019m4,4,2019,COBRA,9166,3975,3591,0,687,2023,2875,22317,13151
Tierra del Fuego,Tren del Fin del Mundo,PN,PATAGONIA,2019m4,4,2019,COBRA,3129,3957,254,0,242,2290,551,10423,7294
Ciervo de los Pantanos,Única,PN,CENTRO,2019m5,5,2019,NO COBRA,0,0,0,0,0,0,0,0,0
El Leoncito,Única,PN,CENTRO,2019m5,5,2019,NO COBRA,165,861,591,78,0,0,0,1695,1530
El Palmar,Única,PN,CENTRO,2019m5,5,2019,COBRA,107,2665,1175,338,393,1308,549,6535,6428
Iberá,Cambyretá,PN,CENTRO,2019m5,5,2019,NO COBRA,113,149,18,113,10,112,40,555,442
Iberá,San Nicolás,PN,CENTRO,2019m5,5,2019,NO COBRA,45,84,65,60,18,0,15,287,242
Mburucuyá,Única,PN,CENTRO,2019m5,5,2019,NO COBRA,10,52,123,44,31,30,58,348,338
Pre Delta,Única,PN,CENTRO,2019m5,5,2019,NO COBRA,28,965,1898,3261,195,264,1320,7931,7903
Quebrada del Condorito,Única,PN,CENTRO,2019m5,5,2019,NO COBRA,224,407,1698,551,0,0,0,2880,2656
San Guillermo,Única,PN,CENTRO,2019m5,5,2019,NO COBRA,0,0,0,0,0,0,0,0,0
Sierra de las Quijadas,Única,PN,CENTRO,2019m5,5,2019,COBRA,125,1102,102,1,38,183,92,1643,1518
Talampaya,Única,PN,CENTRO,2019m5,5,2019,COBRA,345,2451,110,0,209,3250,123,6488,6143
Chaco,Única,PN,NEA,2019m5,5,2019,NO COBRA,18,125,66,60,0,0,23,292,274
Colonia Benítez,Única,RNEd,NEA,2019m5,5,2019,NO COBRA,0,19,0,0,547,0,0,566,566
El Impenetrable,Única,PN,NEA,2019m5,5,2019,NO COBRA,0,0,0,32,0,0,0,32,32
Formosa,Única,RNat,NEA,2019m5,5,2019,NO COBRA,2,1,0,1,0,0,0,4,2
Iguazú,Única,PN,NEA,2019m5,5,2019,COBRA,68115,46091,2184,1537,386,15979,18080,152372,84257
Río Pilcomayo,Estero Poi,PN,NEA,2019m5,5,2019,NO COBRA,0,0,0,0,0,0,0,0,0
Río Pilcomayo,Laguna Blanca,PN,NEA,2019m5,5,2019,NO COBRA,3,12,11,40,0,0,8,74,71
Aconquija,Única,PN,NOA,2019m5,5,2019,NO COBRA,0,2,3,22,6,0,62,95,95
Baritú,Única,PN,NOA,2019m5,5,2019,NO COBRA,0,4,4,0,0,0,0,8,8
Calilegua,Única,PN,NOA,2019m5,5,2019,NO COBRA,249,338,84,463,262,0,301,1697,1448
Copo,Guayacán,PN,NOA,2019m5,5,2019,NO COBRA,0,0,0,0,0,0,0,0,0
Copo,Portada,PN,NOA,2019m5,5,2019,NO COBRA,0,0,0,0,0,0,0,0,0
El Rey,Única,PN,NOA,2019m5,5,2019,NO COBRA,0,0,0,0,0,0,0,0,0
Laguna de los Pozuelos,Única,MN,NOA,2019m5,5,2019,NO COBRA,30,95,20,4,0,0,3,152,122
Los Cardones,Recta del Tín Tín,PN,NOA,2019m5,5,2019,NO COBRA,428,7205,637,82,141,447,89,9029,8601
Los Cardones,Valle Encantado,PN,NOA,2019m5,5,2019,NO COBRA,0,0,0,0,0,0,0,0,0
Nogalar de los Toldos,Única,RNac,NOA,2019m5,5,2019,NO COBRA,0,17,8,22,51,0,0,98,98
Pizarro,Única,RNac,NOA,2019m5,5,2019,NO COBRA,0,0,0,0,0,0,0,0,0
Bosques Petrificados,Única,PN,PATAGONIA,2019m5,5,2019,NO COBRA,36,45,33,0,0,3,11,128,92
Lago Puelo,Única,PN,PATAGONIA,2019m5,5,2019,COBRA,113,2020,250,5040,191,1787,252,9653,9540
Laguna Blanca,Única,PN,PATAGONIA,2019m5,5,2019,NO COBRA,4,15,73,45,29,0,18,184,180
Lanín,Hua Hum,PN,PATAGONIA,2019m5,5,2019,NO COBRA,0,0,0,0,0,0,0,0,0
Lanín,Lago Huechulaufquen,PN,PATAGONIA,2019m5,5,2019,COBRA,86,699,335,0,185,316,131,1752,1666
Lanín,Muelle Lago Lácar,PN,PATAGONIA,2019m5,5,2019,COBRA,68,822,219,64,28,356,149,1706,1638
Lanín,Quila Quina,PN,PATAGONIA,2019m5,5,2019,COBRA,39,489,197,108,79,299,100,1311,1272
Lanín,Ruka Choroy,PN,PATAGONIA,2019m5,5,2019,NO COBRA,0,0,0,0,0,0,0,0,0
Lanín,Volcán Lanín,PN,PATAGONIA,2019m5,5,2019,NO COBRA,0,0,0,0,0,0,0,0,0
Lanín,Área Tromen,PN,PATAGONIA,2019m5,5,2019,NO COBRA,0,0,0,0,0,0,0,0,0
Lanín,Ñorkinko,PN,PATAGONIA,2019m5,5,2019,NO COBRA,0,0,0,0,0,0,0,0,0
Lihué Calel,Única,PN,PATAGONIA,2019m5,5,2019,NO COBRA,22,102,105,82,66,1,76,454,432
Los Alerces,Portada Centro,PN,PATAGONIA,2019m5,5,2019,COBRA,0,0,0,0,0,0,0,0,0
Los Alerces,Portada Norte,PN,PATAGONIA,2019m5,5,2019,COBRA,0,0,0,0,0,0,0,0,0
Los Alerces,Portada Sur,PN,PATAGONIA,2019m5,5,2019,COBRA,0,0,0,0,0,0,0,0,0
Los Alerces,Villa Futalaufquen,PN,PATAGONIA,2019m5,5,2019,NO COBRA,42,152,25,6,0,35,2,262,220
Los Glaciares,El Chaltén,PN,PATAGONIA,2019m5,5,2019,NO COBRA,1850,2106,0,0,0,0,0,3956,2106
Los Glaciares,Puerto Bandera,PN,PATAGONIA,2019m5,5,2019,COBRA,1550,1982,14,1075,230,0,106,4957,3407
Los Glaciares,Puerto La Cruz,PN,PATAGONIA,2019m5,5,2019,NO COBRA,0,0,0,0,0,0,0,0,0
Los Glaciares,Puerto La Soledad,PN,PATAGONIA,2019m5,5,2019,COBRA,27,0,0,4,0,0,0,31,4
Los Glaciares,Puerto Lago Argentino,PN,PATAGONIA,2019m5,5,2019,COBRA,0,0,0,0,0,0,0,0,0
Los Glaciares,Río Mitre,PN,PATAGONIA,2019m5,5,2019,COBRA,9438,6043,745,1826,1182,1782,887,21903,12465
Monte León,Única,PN,PATAGONIA,2019m5,5,2019,NO COBRA,0,0,0,0,0,0,0,0,0
Nahuel Huapi,Lago Mascardi,PN,PATAGONIA,2019m5,5,2019,COBRA,1251,1690,10,678,204,379,41,4253,3002
Nahuel Huapi,Puerto Pañuelo,PN,PATAGONIA,2019m5,5,2019,COBRA,2617,9186,588,760,1882,3667,1479,20179,17562
Nahuel Huapi,Quetrihué,PN,PATAGONIA,2019m5,5,2019,COBRA,344,1256,281,167,144,296,172,2660,2316
Nahuel Huapi,Río Limay,PN,PATAGONIA,2019m5,5,2019,COBRA,0,0,0,0,0,0,0,0,0
Patagonia,Única,PN,PATAGONIA,2019m5,5,2019,NO COBRA,0,0,0,0,0,0,0,0,0
Perito Moreno,Única,PN,PATAGONIA,2019m5,5,2019,NO COBRA,0,0,0,0,0,0,0,0,0
Tierra del Fuego,Ruta Nacional 3,PN,PATAGONIA,2019m5,5,2019,COBRA,1543,1985,2678,0,163,74,723,7166,5623
Tierra del Fuego,Tren del Fin del Mundo,PN,PATAGONIA,2019m5,5,2019,COBRA,1462,4072,549,0,118,1106,531,7838,6376
Ciervo de los Pantanos,Única,PN,CENTRO,2019m6,6,2019,NO COBRA,0,0,0,0,0,0,0,0,0
El Leoncito,Única,PN,CENTRO,2019m6,6,2019,NO COBRA,150,559,643,244,0,0,0,1596,1446
El Palmar,Única,PN,CENTRO,2019m6,6,2019,COBRA,42,2605,1189,292,587,1120,180,6015,5973
Iberá,Cambyretá,PN,CENTRO,2019m6,6,2019,NO COBRA,89,159,10,155,4,51,50,518,429
Iberá,San Nicolás,PN,CENTRO,2019m6,6,2019,NO COBRA,66,307,123,142,50,11,68,767,701
Mburucuyá,Única,PN,CENTRO,2019m6,6,2019,NO COBRA,15,255,192,182,0,35,196,875,860
Pre Delta,Única,PN,CENTRO,2019m6,6,2019,NO COBRA,18,953,1748,2510,152,175,1310,6866,6848
Quebrada del Condorito,Única,PN,CENTRO,2019m6,6,2019,NO COBRA,107,439,1750,121,0,0,0,2417,2310
San Guillermo,Única,PN,CENTRO,2019m6,6,2019,NO COBRA,0,0,0,0,0,0,0,0,0
Sierra de las Quijadas,Única,PN,CENTRO,2019m6,6,2019,COBRA,57,1127,232,2,69,113,243,1843,1786
Talampaya,Única,PN,CENTRO,2019m6,6,2019,COBRA,499,2672,67,0,116,4188,339,7881,7382
Chaco,Única,PN,NEA,2019m6,6,2019,NO COBRA,19,59,210,160,149,0,61,658,639
Colonia Benítez,Única,RNEd,NEA,2019m6,6,2019,NO COBRA,10,15,39,0,264,0,0,328,318
El Impenetrable,Única,PN,NEA,2019m6,6,2019,NO COBRA,0,0,0,0,0,0,0,0,0
Formosa,Única,RNat,NEA,2019m6,6,2019,NO COBRA,2,0,0,0,0,0,0,2,0
Iguazú,Única,PN,NEA,2019m6,6,2019,COBRA,60619,77145,3384,1696,1055,16943,17630,178472,117853
Río Pilcomayo,Estero Poi,PN,NEA,2019m6,6,2019,NO COBRA,0,0,0,0,0,0,0,0,0
Río Pilcomayo,Laguna Blanca,PN,NEA,2019m6,6,2019,NO COBRA,0,0,0,0,0,0,0,0,0
Aconquija,Única,PN,NOA,2019m6,6,2019,NO COBRA,6,22,21,53,51,0,48,201,195
Baritú,Única,PN,NOA,2019m6,6,2019,NO COBRA,16,0,0,0,0,0,0,16,0
Calilegua,Única,PN,NOA,2019m6,6,2019,NO COBRA,121,443,68,290,307,0,256,1485,1364
Copo,Guayacán,PN,NOA,2019m6,6,2019,NO COBRA,0,0,0,0,0,0,0,0,0
Copo,Portada,PN,NOA,2019m6,6,2019,NO COBRA,0,0,0,0,0,0,0,0,0
El Rey,Única,PN,NOA,2019m6,6,2019,NO COBRA,1,1,30,18,0,0,45,95,94
Laguna de los Pozuelos,Única,MN,NOA,2019m6,6,2019,NO COBRA,26,24,7,54,0,0,1,112,86
Los Cardones,Recta del Tín Tín,PN,NOA,2019m6,6,2019,NO COBRA,404,6900,752,410,0,808,345,9619,9215
Los Cardones,Valle Encantado,PN,NOA,2019m6,6,2019,NO COBRA,0,0,0,0,0,0,0,0,0
Nogalar de los Toldos,Única,RNac,NOA,2019m6,6,2019,NO COBRA,29,12,17,18,0,0,17,93,64
Pizarro,Única,RNac,NOA,2019m6,6,2019,NO COBRA,0,0,0,0,0,0,0,0,0
Bosques Petrificados,Única,PN,PATAGONIA,2019m6,6,2019,NO COBRA,3,31,9,0,0,0,4,47,44
Lago Puelo,Única,PN,PATAGONIA,2019m6,6,2019,COBRA,98,1902,98,4692,86,809,339,8024,7926
Laguna Blanca,Única,PN,PATAGONIA,2019m6,6,2019,NO COBRA,2,35,44,54,0,0,21,156,154
Lanín,Hua Hum,PN,PATAGONIA,2019m6,6,2019,NO COBRA,0,0,0,0,0,0,0,0,0
Lanín,Lago Huechulaufquen,PN,PATAGONIA,2019m6,6,2019,COBRA,0,356,0,0,0,294,0,650,650
Lanín,Muelle Lago Lácar,PN,PATAGONIA,2019m6,6,2019,COBRA,53,345,250,22,249,186,396,1501,1448
Lanín,Quila Quina,PN,PATAGONIA,2019m6,6,2019,COBRA,0,332,195,54,66,89,59,795,795
Lanín,Ruka Choroy,PN,PATAGONIA,2019m6,6,2019,NO COBRA,0,0,0,0,0,0,0,0,0
Lanín,Volcán Lanín,PN,PATAGONIA,2019m6,6,2019,NO COBRA,0,0,0,0,0,0,0,0,0
Lanín,Área Tromen,PN,PATAGONIA,2019m6,6,2019,NO COBRA,0,0,0,0,0,0,0,0,0
Lanín,Ñorkinko,PN,PATAGONIA,2019m6,6,2019,NO COBRA,0,0,0,0,0,0,0,0,0
Lihué Calel,Única,PN,PATAGONIA,2019m6,6,2019,NO COBRA,14,69,115,60,110,1,52,421,407
Los Alerces,Portada Centro,PN,PATAGONIA,2019m6,6,2019,COBRA,0,0,0,0,0,0,0,0,0
Los Alerces,Portada Norte,PN,PATAGONIA,2019m6,6,2019,COBRA,0,0,0,0,0,0,0,0,0
Los Alerces,Portada Sur,PN,PATAGONIA,2019m6,6,2019,COBRA,0,0,0,0,0,0,0,0,0
Los Alerces,Villa Futalaufquen,PN,PATAGONIA,2019m6,6,2019,NO COBRA,20,186,22,4,0,30,24,286,266
Los Glaciares,El Chaltén,PN,PATAGONIA,2019m6,6,2019,NO COBRA,1266,1481,0,0,0,0,0,2747,1481
Los Glaciares,Puerto Bandera,PN,PATAGONIA,2019m6,6,2019,COBRA,1443,1126,9,400,214,0,156,3348,1905
Los Glaciares,Puerto La Cruz,PN,PATAGONIA,2019m6,6,2019,NO COBRA,0,0,0,0,0,0,0,0,0
Los Glaciares,Puerto La Soledad,PN,PATAGONIA,2019m6,6,2019,COBRA,0,0,0,0,0,0,0,0,0
Los Glaciares,Puerto Lago Argentino,PN,PATAGONIA,2019m6,6,2019,COBRA,0,0,0,0,0,0,0,0,0
Los Glaciares,Río Mitre,PN,PATAGONIA,2019m6,6,2019,COBRA,7133,3256,530,733,547,1157,570,13926,6793
Monte León,Única,PN,PATAGONIA,2019m6,6,2019,NO COBRA,0,0,0,0,0,0,0,0,0
Nahuel Huapi,Lago Mascardi,PN,PATAGONIA,2019m6,6,2019,COBRA,1700,4164,225,929,592,0,224,7834,6134
Nahuel Huapi,Puerto Pañuelo,PN,PATAGONIA,2019m6,6,2019,COBRA,4962,8647,120,873,1688,3368,1964,21622,16660
Nahuel Huapi,Quetrihué,PN,PATAGONIA,2019m6,6,2019,COBRA,284,2091,300,100,342,229,371,3717,3433
Nahuel Huapi,Río Limay,PN,PATAGONIA,2019m6,6,2019,COBRA,0,0,0,0,0,0,0,0,0
Patagonia,Única,PN,PATAGONIA,2019m6,6,2019,NO COBRA,0,0,0,0,0,0,0,0,0
Perito Moreno,Única,PN,PATAGONIA,2019m6,6,2019,NO COBRA,0,0,0,0,0,0,0,0,0
Tierra del Fuego,Ruta Nacional 3,PN,PATAGONIA,2019m6,6,2019,COBRA,1553,3905,2086,0,58,45,672,8319,6766
Tierra del Fuego,Tren del Fin del Mundo,PN,PATAGONIA,2019m6,6,2019,COBRA,1921,7609,1048,0,0,531,1049,12158,10237
Ciervo de los Pantanos,Única,PN,CENTRO,2019m7,7,2019,NO COBRA,0,0,0,0,0,0,0,0,0
El Leoncito,Única,PN,CENTRO,2019m7,7,2019,NO COBRA,188,5589,1867,151,0,0,0,7795,7607
El Palmar,Única,PN,CENTRO,2019m7,7,2019,COBRA,229,11726,4672,387,335,2631,3316,23296,23067
Iberá,Cambyretá,PN,CENTRO,2019m7,7,2019,NO COBRA,165,859,73,465,80,169,529,2340,2175
Iberá,San Nicolás,PN,CENTRO,2019m7,7,2019,NO COBRA,44,750,176,288,112,15,310,1695,1651
Mburucuyá,Única,PN,CENTRO,2019m7,7,2019,NO COBRA,23,575,582,485,0,102,689,2456,2433
Pre Delta,Única,PN,CENTRO,2019m7,7,2019,NO COBRA,37,2838,2777,3487,3,53,2958,12153,12116
Quebrada del Condorito,Única,PN,CENTRO,2019m7,7,2019,NO COBRA,258,2664,2204,178,0,0,0,5304,5046
San Guillermo,Única,PN,CENTRO,2019m7,7,2019,NO COBRA,0,0,0,0,0,0,0,0,0
Sierra de las Quijadas,Única,PN,CENTRO,2019m7,7,2019,COBRA,139,6350,944,130,46,209,2483,10301,10162
Talampaya,Única,PN,CENTRO,2019m7,7,2019,COBRA,1261,13575,550,68,1309,3436,4350,24549,23288
Chaco,Única,PN,NEA,2019m7,7,2019,NO COBRA,13,249,530,1126,395,0,360,2673,2660
Colonia Benítez,Única,RNEd,NEA,2019m7,7,2019,NO COBRA,0,0,0,23,490,0,0,513,513
El Impenetrable,Única,PN,NEA,2019m7,7,2019,NO COBRA,0,95,2,2,0,0,2,101,101
Formosa,Única,RNat,NEA,2019m7,7,2019,NO COBRA,0,16,3,4,1,2,6,32,32
Iguazú,Única,PN,NEA,2019m7,7,2019,COBRA,75815,129802,4716,1798,159,20400,49959,282649,206834
Río Pilcomayo,Estero Poi,PN,NEA,2019m7,7,2019,NO COBRA,4,103,13,90,9,3,47,269,265
Río Pilcomayo,Laguna Blanca,PN,NEA,2019m7,7,2019,NO COBRA,15,237,186,175,1,0,191,805,790
Aconquija,Única,PN,NOA,2019m7,7,2019,NO COBRA,22,167,143,141,76,0,217,766,744
Baritú,Única,PN,NOA,2019m7,7,2019,NO COBRA,4,31,1,0,0,0,0,36,32
Calilegua,Única,PN,NOA,2019m7,7,2019,NO COBRA,282,2669,702,1146,1160,0,1722,7681,7399
Copo,Guayacán,PN,NOA,2019m7,7,2019,NO COBRA,0,0,0,0,0,0,0,0,0
Copo,Portada,PN,NOA,2019m7,7,2019,NO COBRA,0,0,0,0,0,0,0,0,0
El Rey,Única,PN,NOA,2019m7,7,2019,NO COBRA,9,132,71,64,0,0,111,387,378
Laguna de los Pozuelos,Única,MN,NOA,2019m7,7,2019,NO COBRA,73,177,37,4,8,0,49,348,275
Los Cardones,Recta del Tín Tín,PN,NOA,2019m7,7,2019,NO COBRA,1527,10594,499,496,45,6225,108,19494,17967
Los Cardones,Valle Encantado,PN,NOA,2019m7,7,2019,NO COBRA,0,0,0,0,0,0,0,0,0
Nogalar de los Toldos,Única,RNac,NOA,2019m7,7,2019,NO COBRA,3,33,29,37,10,0,0,112,109
Pizarro,Única,RNac,NOA,2019m7,7,2019,NO COBRA,0,0,0,0,0,0,0,0,0
Bosques Petrificados,Única,PN,PATAGONIA,2019m7,7,2019,NO COBRA,10,18,29,4,0,0,22,83,73
Lago Puelo,Única,PN,PATAGONIA,2019m7,7,2019,COBRA,167,3608,638,4662,206,545,549,10375,10208
Laguna Blanca,Única,PN,PATAGONIA,2019m7,7,2019,NO COBRA,10,48,106,81,62,0,52,359,349
Lanín,Hua Hum,PN,PATAGONIA,2019m7,7,2019,NO COBRA,0,0,0,0,0,0,0,0,0
Lanín,Lago Huechulaufquen,PN,PATAGONIA,2019m7,7,2019,COBRA,0,394,0,0,0,0,0,394,394
Lanín,Muelle Lago Lácar,PN,PATAGONIA,2019m7,7,2019,COBRA,313,2261,443,75,546,366,793,4797,4484
Lanín,Quila Quina,PN,PATAGONIA,2019m7,7,2019,COBRA,19,548,185,83,96,121,137,1189,1170
Lanín,Ruka Choroy,PN,PATAGONIA,2019m7,7,2019,NO COBRA,0,0,0,0,0,0,0,0,0
Lanín,Volcán Lanín,PN,PATAGONIA,2019m7,7,2019,NO COBRA,0,0,0,0,0,0,0,0,0
Lanín,Área Tromen,PN,PATAGONIA,2019m7,7,2019,NO COBRA,0,0,0,0,0,0,0,0,0
Lanín,Ñorkinko,PN,PATAGONIA,2019m7,7,2019,NO COBRA,0,0,0,0,0,0,0,0,0
Lihué Calel,Única,PN,PATAGONIA,2019m7,7,2019,NO COBRA,27,269,134,31,18,3,236,718,691
Los Alerces,Portada Centro,PN,PATAGONIA,2019m7,7,2019,COBRA,0,0,0,0,0,0,0,0,0
Los Alerces,Portada Norte,PN,PATAGONIA,2019m7,7,2019,COBRA,0,0,0,0,0,0,0,0,0
Los Alerces,Portada Sur,PN,PATAGONIA,2019m7,7,2019,COBRA,0,0,0,0,0,0,0,0,0
Los Alerces,Villa Futalaufquen,PN,PATAGONIA,2019m7,7,2019,NO COBRA,45,785,205,19,0,0,208,1262,1217
Los Glaciares,El Chaltén,PN,PATAGONIA,2019m7,7,2019,NO COBRA,1998,2690,0,0,0,0,0,4688,2690
Los Glaciares,Puerto Bandera,PN,PATAGONIA,2019m7,7,2019,COBRA,2667,1879,29,462,164,0,339,5540,2873
Los Glaciares,Puerto La Cruz,PN,PATAGONIA,2019m7,7,2019,NO COBRA,0,0,0,0,0,0,0,0,0
Los Glaciares,Puerto La Soledad,PN,PATAGONIA,2019m7,7,2019,COBRA,0,0,0,0,0,0,0,0,0
Los Glaciares,Puerto Lago Argentino,PN,PATAGONIA,2019m7,7,2019,COBRA,0,0,0,0,0,0,0,0,0
Los Glaciares,Río Mitre,PN,PATAGONIA,2019m7,7,2019,COBRA,8473,7510,986,1633,1120,1286,1901,22909,14436
Monte León,Única,PN,PATAGONIA,2019m7,7,2019,NO COBRA,0,0,0,0,0,0,0,0,0
Nahuel Huapi,Lago Mascardi,PN,PATAGONIA,2019m7,7,2019,COBRA,2240,3232,416,694,898,203,155,7838,5598
Nahuel Huapi,Puerto Pañuelo,PN,PATAGONIA,2019m7,7,2019,COBRA,11020,16515,321,697,14841,2478,3790,49662,38642
Nahuel Huapi,Quetrihué,PN,PATAGONIA,2019m7,7,2019,COBRA,443,3097,435,98,394,139,1214,5820,5377
Nahuel Huapi,Río Limay,PN,PATAGONIA,2019m7,7,2019,COBRA,0,0,0,0,0,0,0,0,0
Patagonia,Única,PN,PATAGONIA,2019m7,7,2019,NO COBRA,0,0,0,0,0,0,0,0,0
Perito Moreno,Única,PN,PATAGONIA,2019m7,7,2019,NO COBRA,0,0,0,0,0,0,0,0,0
Tierra del Fuego,Ruta Nacional 3,PN,PATAGONIA,2019m7,7,2019,COBRA,2097,4635,3273,0,4,48,1093,11150,9053
Tierra del Fuego,Tren del Fin del Mundo,PN,PATAGONIA,2019m7,7,2019,COBRA,2643,11492,561,0,0,382,3844,18922,16279
Ciervo de los Pantanos,Única,PN,CENTRO,2019m8,8,2019,NO COBRA,0,0,0,0,0,0,0,0,0
El Leoncito,Única,PN,CENTRO,2019m8,8,2019,NO COBRA,49,937,603,104,0,0,0,1693,1644
El Palmar,Única,PN,CENTRO,2019m8,8,2019,COBRA,136,6951,2071,544,361,1366,1782,13211,13075
Iberá,Cambyretá,PN,CENTRO,2019m8,8,2019,NO COBRA,171,494,49,331,47,123,251,1466,1295
Iberá,San Nicolás,PN,CENTRO,2019m8,8,2019,NO COBRA,77,185,82,110,196,200,48,898,821
Mburucuyá,Única,PN,CENTRO,2019m8,8,2019,NO COBRA,29,251,274,300,135,0,337,1326,1297
Pre Delta,Única,PN,CENTRO,2019m8,8,2019,NO COBRA,28,1973,2104,4305,292,99,1919,10720,10692
Quebrada del Condorito,Única,PN,CENTRO,2019m8,8,2019,NO COBRA,187,752,846,160,0,0,0,1945,1758
San Guillermo,Única,PN,CENTRO,2019m8,8,2019,NO COBRA,0,0,0,0,0,0,0,0,0
Sierra de las Quijadas,Única,PN,CENTRO,2019m8,8,2019,COBRA,105,1344,298,9,42,150,401,2349,2244
Talampaya,Única,PN,CENTRO,2019m8,8,2019,COBRA,542,3482,62,15,527,4206,430,9264,8722
Chaco,Única,PN,NEA,2019m8,8,2019,NO COBRA,7,99,430,661,550,0,113,1860,1853
Colonia Benítez,Única,RNEd,NEA,2019m8,8,2019,NO COBRA,0,12,9,0,517,0,0,538,538
El Impenetrable,Única,PN,NEA,2019m8,8,2019,NO COBRA,7,58,79,31,4,2,2,183,176
Formosa,Única,RNat,NEA,2019m8,8,2019,NO COBRA,2,3,0,0,0,0,0,5,3
Iguazú,Única,PN,NEA,2019m8,8,2019,COBRA,65657,91285,4555,1729,3003,19822,20104,206155,140498
Río Pilcomayo,Estero Poi,PN,NEA,2019m8,8,2019,NO COBRA,30,107,111,158,28,2,45,481,451
Río Pilcomayo,Laguna Blanca,PN,NEA,2019m8,8,2019,NO COBRA,23,131,201,223,181,14,106,879,856
Aconquija,Única,PN,NOA,2019m8,8,2019,NO COBRA,8,145,148,266,166,0,106,839,831
Baritú,Única,PN,NOA,2019m8,8,2019,NO COBRA,47,14,2,0,0,0,4,67,20
Calilegua,Única,PN,NOA,2019m8,8,2019,NO COBRA,236,945,220,211,524,0,366,2502,2266
Copo,Guayacán,PN,NOA,2019m8,8,2019,NO COBRA,0,0,0,0,0,0,0,0,0
Copo,Portada,PN,NOA,2019m8,8,2019,NO COBRA,0,0,0,0,0,0,0,0,0
El Rey,Única,PN,NOA,2019m8,8,2019,NO COBRA,16,37,71,10,0,0,87,221,205
Laguna de los Pozuelos,Única,MN,NOA,2019m8,8,2019,NO COBRA,70,60,28,1,2,0,10,171,101
Los Cardones,Recta del Tín Tín,PN,NOA,2019m8,8,2019,NO COBRA,408,7384,525,449,95,4850,118,13829,13421
Los Cardones,Valle Encantado,PN,NOA,2019m8,8,2019,NO COBRA,0,0,0,0,0,0,0,0,0
Nogalar de los Toldos,Única,RNac,NOA,2019m8,8,2019,NO COBRA,1,17,23,30,38,0,40,149,148
Pizarro,Única,RNac,NOA,2019m8,8,2019,NO COBRA,0,0,0,0,0,0,0,0,0
Bosques Petrificados,Única,PN,PATAGONIA,2019m8,8,2019,NO COBRA,9,10,22,6,0,0,9,56,47
Lago Puelo,Única,PN,PATAGONIA,2019m8,8,2019,COBRA,103,3016,401,6176,453,479,480,11108,11005
Laguna Blanca,Única,PN,PATAGONIA,2019m8,8,2019,NO COBRA,0,35,33,35,23,0,0,126,126
Lanín,Hua Hum,PN,PATAGONIA,2019m8,8,2019,NO COBRA,0,0,0,0,0,0,0,0,0
Lanín,Lago Huechulaufquen,PN,PATAGONIA,2019m8,8,2019,COBRA,119,1358,76,0,127,171,113,1964,1845
Lanín,Muelle Lago Lácar,PN,PATAGONIA,2019m8,8,2019,COBRA,133,1946,175,57,588,182,465,3546,3413
Lanín,Quila Quina,PN,PATAGONIA,2019m8,8,2019,COBRA,4,384,110,18,102,40,64,722,718
Lanín,Ruka Choroy,PN,PATAGONIA,2019m8,8,2019,NO COBRA,0,0,0,0,0,0,0,0,0
Lanín,Volcán Lanín,PN,PATAGONIA,2019m8,8,2019,NO COBRA,0,0,0,0,0,0,0,0,0
Lanín,Área Tromen,PN,PATAGONIA,2019m8,8,2019,NO COBRA,0,0,0,0,0,0,0,0,0
Lanín,Ñorkinko,PN,PATAGONIA,2019m8,8,2019,NO COBRA,0,0,0,0,0,0,0,0,0
Lihué Calel,Única,PN,PATAGONIA,2019m8,8,2019,NO COBRA,0,84,123,42,712,2,26,989,989
Los Alerces,Portada Centro,PN,PATAGONIA,2019m8,8,2019,COBRA,0,0,0,0,0,0,0,0,0
Los Alerces,Portada Norte,PN,PATAGONIA,2019m8,8,2019,COBRA,0,0,0,0,0,0,0,0,0
Los Alerces,Portada Sur,PN,PATAGONIA,2019m8,8,2019,COBRA,0,0,0,0,0,0,0,0,0
Los Alerces,Villa Futalaufquen,PN,PATAGONIA,2019m8,8,2019,NO COBRA,70,538,38,6,0,0,53,705,635
Los Glaciares,El Chaltén,PN,PATAGONIA,2019m8,8,2019,NO COBRA,3056,3309,0,0,0,0,0,6365,3309
Los Glaciares,Puerto Bandera,PN,PATAGONIA,2019m8,8,2019,COBRA,3659,2954,42,562,234,0,171,7622,3963
Los Glaciares,Puerto La Cruz,PN,PATAGONIA,2019m8,8,2019,NO COBRA,0,0,0,0,0,0,0,0,0
Los Glaciares,Puerto La Soledad,PN,PATAGONIA,2019m8,8,2019,COBRA,0,0,0,0,0,0,0,0,0
Los Glaciares,Puerto Lago Argentino,PN,PATAGONIA,2019m8,8,2019,COBRA,0,0,0,0,0,0,0,0,0
Los Glaciares,Río Mitre,PN,PATAGONIA,2019m8,8,2019,COBRA,14188,6611,975,1584,1301,1909,1104,27672,13484
Monte León,Única,PN,PATAGONIA,2019m8,8,2019,NO COBRA,0,0,0,0,0,0,0,0,0
Nahuel Huapi,Lago Mascardi,PN,PATAGONIA,2019m8,8,2019,COBRA,2891,1707,3,765,317,72,0,5755,2864
Nahuel Huapi,Puerto Pañuelo,PN,PATAGONIA,2019m8,8,2019,COBRA,8190,10364,151,1148,17065,2200,2106,41224,33034
Nahuel Huapi,Quetrihué,PN,PATAGONIA,2019m8,8,2019,COBRA,111,942,69,28,201,100,348,1799,1688
Nahuel Huapi,Río Limay,PN,PATAGONIA,2019m8,8,2019,COBRA,0,0,0,0,0,0,0,0,0
Patagonia,Única,PN,PATAGONIA,2019m8,8,2019,NO COBRA,0,0,0,0,0,0,0,0,0
Perito Moreno,Única,PN,PATAGONIA,2019m8,8,2019,NO COBRA,0,0,0,0,0,0,0,0,0
Tierra del Fuego,Ruta Nacional 3,PN,PATAGONIA,2019m8,8,2019,COBRA,2737,4518,3078,0,3,81,664,11081,8344
Tierra del Fuego,Tren del Fin del Mundo,PN,PATAGONIA,2019m8,8,2019,COBRA,3726,5723,427,0,0,865,1270,12011,8285
Ciervo de los Pantanos,Única,PN,CENTRO,2019m9,9,2019,NO COBRA,3,14,653,210,507,0,175,1562,1559
El Leoncito,Única,PN,CENTRO,2019m9,9,2019,NO COBRA,161,1002,488,335,0,0,0,1986,1825
El Palmar,Única,PN,CENTRO,2019m9,9,2019,COBRA,169,4520,3160,547,437,1847,1950,12630,12461
Iberá,Cambyretá,PN,CENTRO,2019m9,9,2019,NO COBRA,242,502,64,334,124,79,161,1506,1264
Iberá,San Nicolás,PN,CENTRO,2019m9,9,2019,NO COBRA,64,170,175,200,269,18,46,942,878
Mburucuyá,Única,PN,CENTRO,2019m9,9,2019,NO COBRA,20,252,229,216,34,53,282,1086,1066
Pre Delta,Única,PN,CENTRO,2019m9,9,2019,NO COBRA,104,2409,4244,4317,607,286,2830,14797,14693
Quebrada del Condorito,Única,PN,CENTRO,2019m9,9,2019,NO COBRA,409,609,2415,198,0,0,0,3631,3222
San Guillermo,Única,PN,CENTRO,2019m9,9,2019,NO COBRA,0,0,0,0,0,0,0,0,0
Sierra de las Quijadas,Única,PN,CENTRO,2019m9,9,2019,COBRA,98,1429,277,4,31,147,193,2179,2081
Talampaya,Única,PN,CENTRO,2019m9,9,2019,COBRA,548,3209,191,6,508,4839,505,9806,9258
Chaco,Única,PN,NEA,2019m9,9,2019,NO COBRA,24,266,430,1008,220,0,109,2057,2033
Colonia Benítez,Única,RNEd,NEA,2019m9,9,2019,NO COBRA,4,0,0,0,212,9,0,225,221
El Impenetrable,Única,PN,NEA,2019m9,9,2019,NO COBRA,0,188,18,0,0,0,0,206,206
Formosa,Única,RNat,NEA,2019m9,9,2019,NO COBRA,9,10,2,3,0,0,1,25,16
Iguazú,Única,PN,NEA,2019m9,9,2019,COBRA,58067,61366,2425,1744,3340,25730,28751,181423,123356
Río Pilcomayo,Estero Poi,PN,NEA,2019m9,9,2019,NO COBRA,95,44,151,141,24,12,83,550,455
Río Pilcomayo,Laguna Blanca,PN,NEA,2019m9,9,2019,NO COBRA,4,179,236,569,145,2,188,1323,1319
Aconquija,Única,PN,NOA,2019m9,9,2019,NO COBRA,3,52,306,605,205,0,228,1399,1396
Baritú,Única,PN,NOA,2019m9,9,2019,NO COBRA,9,8,11,0,0,0,1,29,20
Calilegua,Única,PN,NOA,2019m9,9,2019,NO COBRA,225,988,333,319,1554,0,640,4059,3834
Copo,Guayacán,PN,NOA,2019m9,9,2019,NO COBRA,0,0,0,0,0,0,0,0,0
Copo,Portada,PN,NOA,2019m9,9,2019,NO COBRA,0,0,0,0,0,0,0,0,0
El Rey,Única,PN,NOA,2019m9,9,2019,NO COBRA,17,41,42,45,0,0,54,199,182
Laguna de los Pozuelos,Única,MN,NOA,2019m9,9,2019,NO COBRA,38,55,13,24,0,4,15,149,111
Los Cardones,Recta del Tín Tín,PN,NOA,2019m9,9,2019,NO COBRA,748,9092,366,102,91,2784,48,13231,12483
Los Cardones,Valle Encantado,PN,NOA,2019m9,9,2019,NO COBRA,0,0,0,0,0,0,0,0,0
Nogalar de los Toldos,Única,RNac,NOA,2019m9,9,2019,NO COBRA,14,17,17,28,429,1,21,527,513
Pizarro,Única,RNac,NOA,2019m9,9,2019,NO COBRA,0,0,0,0,0,0,0,0,0
Bosques Petrificados,Única,PN,PATAGONIA,2019m9,9,2019,NO COBRA,12,47,6,22,0,9,33,129,117
Lago Puelo,Única,PN,PATAGONIA,2019m9,9,2019,COBRA,339,2139,455,8838,617,1628,344,14360,14021
Laguna Blanca,Única,PN,PATAGONIA,2019m9,9,2019,NO COBRA,2,67,42,38,0,0,23,172,170
Lanín,Hua Hum,PN,PATAGONIA,2019m9,9,2019,NO COBRA,0,0,0,0,0,0,0,0,0
Lanín,Lago Huechulaufquen,PN,PATAGONIA,2019m9,9,2019,COBRA,0,280,0,139,125,127,0,671,671
Lanín,Muelle Lago Lácar,PN,PATAGONIA,2019m9,9,2019,COBRA,393,1163,274,68,253,493,348,2992,2599
Lanín,Quila Quina,PN,PATAGONIA,2019m9,9,2019,COBRA,91,1010,237,293,93,281,232,2237,2146
Lanín,Ruka Choroy,PN,PATAGONIA,2019m9,9,2019,NO COBRA,0,0,0,0,0,0,0,0,0
Lanín,Volcán Lanín,PN,PATAGONIA,2019m9,9,2019,NO COBRA,0,0,0,0,0,0,0,0,0
Lanín,Área Tromen,PN,PATAGONIA,2019m9,9,2019,NO COBRA,0,0,0,0,0,0,0,0,0
Lanín,Ñorkinko,PN,PATAGONIA,2019m9,9,2019,NO COBRA,0,0,0,0,0,0,0,0,0
Lihué Calel,Única,PN,PATAGONIA,2019m9,9,2019,NO COBRA,10,123,225,21,519,3,47,948,938
Los Alerces,Portada Centro,PN,PATAGONIA,2019m9,9,2019,COBRA,0,0,0,0,0,0,0,0,0
Los Alerces,Portada Norte,PN,PATAGONIA,2019m9,9,2019,COBRA,0,0,0,0,0,0,0,0,0
Los Alerces,Portada Sur,PN,PATAGONIA,2019m9,9,2019,COBRA,0,0,0,0,0,0,0,0,0
Los Alerces,Villa Futalaufquen,PN,PATAGONIA,2019m9,9,2019,NO COBRA,57,578,52,24,2,103,141,957,900
Los Glaciares,El Chaltén,PN,PATAGONIA,2019m9,9,2019,NO COBRA,4681,4692,0,0,0,0,0,9373,4692
Los Glaciares,Puerto Bandera,PN,PATAGONIA,2019m9,9,2019,COBRA,4773,2774,33,2427,186,0,236,10429,5656
Los Glaciares,Puerto La Cruz,PN,PATAGONIA,2019m9,9,2019,NO COBRA,0,0,0,0,0,0,0,0,0
Los Glaciares,Puerto La Soledad,PN,PATAGONIA,2019m9,9,2019,COBRA,0,0,0,0,0,0,0,0,0
Los Glaciares,Puerto Lago Argentino,PN,PATAGONIA,2019m9,9,2019,COBRA,0,0,0,0,0,0,0,0,0
Los Glaciares,Río Mitre,PN,PATAGONIA,2019m9,9,2019,COBRA,21658,10500,910,2072,620,6779,1182,43721,22063
Monte León,Única,PN,PATAGONIA,2019m9,9,2019,NO COBRA,0,0,0,0,0,0,0,0,0
Nahuel Huapi,Lago Mascardi,PN,PATAGONIA,2019m9,9,2019,COBRA,559,995,0,288,162,4,0,2008,1449
Nahuel Huapi,Puerto Pañuelo,PN,PATAGONIA,2019m9,9,2019,COBRA,7224,6562,199,1179,14000,2581,2009,33754,26530
Nahuel Huapi,Quetrihué,PN,PATAGONIA,2019m9,9,2019,COBRA,951,1228,321,128,728,301,666,4323,3372
Nahuel Huapi,Río Limay,PN,PATAGONIA,2019m9,9,2019,COBRA,0,0,0,0,553,0,0,553,553
Patagonia,Única,PN,PATAGONIA,2019m9,9,2019,NO COBRA,0,0,0,0,0,0,0,0,0
Perito Moreno,Única,PN,PATAGONIA,2019m9,9,2019,NO COBRA,0,0,0,0,0,0,0,0,0
Tierra del Fuego,Ruta Nacional 3,PN,PATAGONIA,2019m9,9,2019,COBRA,4420,6910,3194,0,412,129,1230,16295,11875
Tierra del Fuego,Tren del Fin del Mundo,PN,PATAGONIA,2019m9,9,2019,COBRA,3069,6642,371,0,0,1808,1246,13136,10067
Ciervo de los Pantanos,Única,PN,CENTRO,2019m10,10,2019,NO COBRA,14,2,981,507,767,0,709,2980,2966
El Leoncito,Única,PN,CENTRO,2019m10,10,2019,NO COBRA,254,908,614,315,0,0,0,2091,1837
El Palmar,Única,PN,CENTRO,2019m10,10,2019,COBRA,225,3336,2219,496,488,1732,3713,12209,11984
Iberá,Cambyretá,PN,CENTRO,2019m10,10,2019,NO COBRA,293,358,25,154,24,12,63,929,636
Iberá,San Nicolás,PN,CENTRO,2019m10,10,2019,NO COBRA,37,114,80,61,184,4,23,503,466
Mburucuyá,Única,PN,CENTRO,2019m10,10,2019,NO COBRA,12,111,102,68,0,4,151,448,436
Pre Delta,Única,PN,CENTRO,2019m10,10,2019,NO COBRA,94,924,1527,1757,1336,146,1759,7543,7449
Quebrada del Condorito,Única,PN,CENTRO,2019m10,10,2019,NO COBRA,284,507,2666,322,0,0,0,3779,3495
San Guillermo,Única,PN,CENTRO,2019m10,10,2019,NO COBRA,2,21,0,0,0,0,0,23,21
Sierra de las Quijadas,Única,PN,CENTRO,2019m10,10,2019,COBRA,87,998,77,15,0,182,111,1470,1383
Talampaya,Única,PN,CENTRO,2019m10,10,2019,COBRA,565,5261,53,14,434,4083,347,10757,10192
Chaco,Única,PN,NEA,2019m10,10,2019,NO COBRA,39,70,168,131,417,0,29,854,815
Colonia Benítez,Única,RNEd,NEA,2019m10,10,2019,NO COBRA,0,60,5,0,342,0,0,407,407
El Impenetrable,Única,PN,NEA,2019m10,10,2019,NO COBRA,0,180,0,0,0,0,0,180,180
Formosa,Única,RNat,NEA,2019m10,10,2019,NO COBRA,2,9,0,3,0,0,0,14,12
Iguazú,Única,PN,NEA,2019m10,10,2019,COBRA,78905,49225,3455,1536,9131,20869,26319,189440,110535
Río Pilcomayo,Estero Poi,PN,NEA,2019m10,10,2019,NO COBRA,9,14,19,24,0,0,21,87,78
Río Pilcomayo,Laguna Blanca,PN,NEA,2019m10,10,2019,NO COBRA,85,122,194,777,2,0,232,1412,1327
Aconquija,Única,PN,NOA,2019m10,10,2019,NO COBRA,2,63,492,390,27,4,81,1059,1057
Baritú,Única,PN,NOA,2019m10,10,2019,NO COBRA,0,12,4,0,20,1,0,37,37
Calilegua,Única,PN,NOA,2019m10,10,2019,NO COBRA,203,860,698,442,1250,0,203,3656,3453
Copo,Guayacán,PN,NOA,2019m10,10,2019,NO COBRA,0,0,0,0,0,0,0,0,0
Copo,Portada,PN,NOA,2019m10,10,2019,NO COBRA,0,0,0,0,0,0,0,0,0
El Rey,Única,PN,NOA,2019m10,10,2019,NO COBRA,9,20,22,64,0,0,50,165,156
Laguna de los Pozuelos,Única,MN,NOA,2019m10,10,2019,NO COBRA,76,67,46,2,112,0,8,311,235
Los Cardones,Recta del Tín Tín,PN,NOA,2019m10,10,2019,NO COBRA,1187,5317,539,98,200,5208,123,12672,11485
Los Cardones,Valle Encantado,PN,NOA,2019m10,10,2019,NO COBRA,0,0,0,0,0,0,0,0,0
Nogalar de los Toldos,Única,RNac,NOA,2019m10,10,2019,NO COBRA,0,4,22,15,41,1,3,86,86
Pizarro,Única,RNac,NOA,2019m10,10,2019,NO COBRA,0,0,0,0,0,0,0,0,0
Bosques Petrificados,Única,PN,PATAGONIA,2019m10,10,2019,NO COBRA,111,60,84,10,51,121,74,511,400
Lago Puelo,Única,PN,PATAGONIA,2019m10,10,2019,COBRA,457,6739,1588,9837,1912,2693,573,23799,23342
Laguna Blanca,Única,PN,PATAGONIA,2019m10,10,2019,NO COBRA,17,27,65,131,290,0,33,563,546
Lanín,Hua Hum,PN,PATAGONIA,2019m10,10,2019,NO COBRA,0,0,0,0,0,0,0,0,0
Lanín,Lago Huechulaufquen,PN,PATAGONIA,2019m10,10,2019,COBRA,102,1108,115,199,119,966,343,2952,2850
Lanín,Muelle Lago Lácar,PN,PATAGONIA,2019m10,10,2019,COBRA,180,1557,382,34,752,740,361,4006,3826
Lanín,Quila Quina,PN,PATAGONIA,2019m10,10,2019,COBRA,90,1176,491,332,170,415,311,2985,2895
Lanín,Ruka Choroy,PN,PATAGONIA,2019m10,10,2019,NO COBRA,0,0,0,0,0,0,0,0,0
Lanín,Volcán Lanín,PN,PATAGONIA,2019m10,10,2019,NO COBRA,0,0,0,0,0,0,0,0,0
Lanín,Área Tromen,PN,PATAGONIA,2019m10,10,2019,NO COBRA,0,0,0,0,0,0,0,0,0
Lanín,Ñorkinko,PN,PATAGONIA,2019m10,10,2019,NO COBRA,0,0,0,0,0,0,0,0,0
Lihué Calel,Única,PN,PATAGONIA,2019m10,10,2019,NO COBRA,49,117,369,102,1002,2,58,1699,1650
Los Alerces,Portada Centro,PN,PATAGONIA,2019m10,10,2019,COBRA,0,0,0,0,0,0,0,0,0
Los Alerces,Portada Norte,PN,PATAGONIA,2019m10,10,2019,COBRA,0,0,0,0,0,0,0,0,0
Los Alerces,Portada Sur,PN,PATAGONIA,2019m10,10,2019,COBRA,0,0,0,0,0,0,0,0,0
Los Alerces,Villa Futalaufquen,PN,PATAGONIA,2019m10,10,2019,NO COBRA,240,1214,96,55,0,919,148,2672,2432
Los Glaciares,El Chaltén,PN,PATAGONIA,2019m10,10,2019,NO COBRA,9914,8924,0,0,0,0,0,18838,8924
Los Glaciares,Puerto Bandera,PN,PATAGONIA,2019m10,10,2019,COBRA,4242,2584,11,3538,225,0,100,10700,6458
Los Glaciares,Puerto La Cruz,PN,PATAGONIA,2019m10,10,2019,NO COBRA,0,0,0,0,0,0,0,0,0
Los Glaciares,Puerto La Soledad,PN,PATAGONIA,2019m10,10,2019,COBRA,820,0,0,0,0,0,0,820,0
Los Glaciares,Puerto Lago Argentino,PN,PATAGONIA,2019m10,10,2019,COBRA,0,0,0,0,0,0,0,0,0
Los Glaciares,Río Mitre,PN,PATAGONIA,2019m10,10,2019,COBRA,44100,13355,1849,3456,882,7137,2132,72911,28811
Monte León,Única,PN,PATAGONIA,2019m10,10,2019,NO COBRA,123,49,162,76,64,0,153,627,504
Nahuel Huapi,Lago Mascardi,PN,PATAGONIA,2019m10,10,2019,COBRA,533,708,34,791,142,11,1,2220,1687
Nahuel Huapi,Puerto Pañuelo,PN,PATAGONIA,2019m10,10,2019,COBRA,4729,12094,420,2126,11546,4219,1292,36426,31697
Nahuel Huapi,Quetrihué,PN,PATAGONIA,2019m10,10,2019,COBRA,555,3274,793,180,1819,497,490,7608,7053
Nahuel Huapi,Río Limay,PN,PATAGONIA,2019m10,10,2019,COBRA,0,0,835,307,9953,0,0,11095,11095
Patagonia,Única,PN,PATAGONIA,2019m10,10,2019,NO COBRA,0,0,0,0,0,0,0,0,0
Perito Moreno,Única,PN,PATAGONIA,2019m10,10,2019,NO COBRA,13,11,23,0,0,0,9,56,43
Tierra del Fuego,Ruta Nacional 3,PN,PATAGONIA,2019m10,10,2019,COBRA,12650,6776,6666,0,420,3820,4002,34334,21684
Tierra del Fuego,Tren del Fin del Mundo,PN,PATAGONIA,2019m10,10,2019,COBRA,4615,7191,251,0,3,2699,873,15632,11017
Ciervo de los Pantanos,Única,PN,CENTRO,2019m11,11,2019,NO COBRA,14,15,1181,747,250,0,618,2825,2811
El Leoncito,Única,PN,CENTRO,2019m11,11,2019,NO COBRA,317,893,984,149,0,0,0,2343,2026
El Palmar,Única,PN,CENTRO,2019m11,11,2019,COBRA,240,7344,4138,597,708,1175,4560,18762,18522
Iberá,Cambyretá,PN,CENTRO,2019m11,11,2019,NO COBRA,262,225,51,230,84,69,97,1018,756
Iberá,San Nicolás,PN,CENTRO,2019m11,11,2019,NO COBRA,61,75,101,93,83,14,18,445,384
Mburucuyá,Única,PN,CENTRO,2019m11,11,2019,NO COBRA,12,136,252,114,405,25,107,1051,1039
Pre Delta,Única,PN,CENTRO,2019m11,11,2019,NO COBRA,62,1374,2319,3613,1403,664,2218,11653,11591
Quebrada del Condorito,Única,PN,CENTRO,2019m11,11,2019,NO COBRA,349,899,1658,143,0,0,0,3049,2700
San Guillermo,Única,PN,CENTRO,2019m11,11,2019,NO COBRA,0,14,24,1,0,0,0,39,39
Sierra de las Quijadas,Única,PN,CENTRO,2019m11,11,2019,COBRA,113,1262,156,0,39,84,134,1788,1675
Talampaya,Única,PN,CENTRO,2019m11,11,2019,COBRA,903,2842,263,0,192,3792,133,8125,7222
Chaco,Única,PN,NEA,2019m11,11,2019,NO COBRA,13,195,267,172,216,0,18,881,868
Colonia Benítez,Única,RNEd,NEA,2019m11,11,2019,NO COBRA,0,4,82,2,68,0,0,156,156
El Impenetrable,Única,PN,NEA,2019m11,11,2019,NO COBRA,0,19,6,2,0,0,0,27,27
Formosa,Única,RNat,NEA,2019m11,11,2019,NO COBRA,0,7,0,0,0,0,0,7,7
Iguazú,Única,PN,NEA,2019m11,11,2019,COBRA,135806,67848,5013,2220,6778,11633,20760,250058,114252
Río Pilcomayo,Estero Poi,PN,NEA,2019m11,11,2019,NO COBRA,21,60,3,88,2,11,15,200,179
Río Pilcomayo,Laguna Blanca,PN,NEA,2019m11,11,2019,NO COBRA,24,73,190,657,0,0,292,1236,1212
Aconquija,Única,PN,NOA,2019m11,11,2019,NO COBRA,2,18,63,143,0,0,48,274,272
Baritú,Única,PN,NOA,2019m11,11,2019,NO COBRA,0,4,0,0,0,0,0,4,4
Calilegua,Única,PN,NOA,2019m11,11,2019,NO COBRA,478,651,131,397,1618,0,225,3500,3022
Copo,Guayacán,PN,NOA,2019m11,11,2019,NO COBRA,0,0,0,0,0,0,0,0,0
Copo,Portada,PN,NOA,2019m11,11,2019,NO COBRA,0,0,0,0,0,0,0,0,0
El Rey,Única,PN,NOA,2019m11,11,2019,NO COBRA,9,20,32,31,0,0,28,120,111
Laguna de los Pozuelos,Única,MN,NOA,2019m11,11,2019,NO COBRA,118,75,24,17,73,0,4,311,193
Los Cardones,Recta del Tín Tín,PN,NOA,2019m11,11,2019,NO COBRA,789,3565,351,163,62,2620,49,7599,6810
Los Cardones,Valle Encantado,PN,NOA,2019m11,11,2019,NO COBRA,0,0,0,0,0,0,0,0,0
Nogalar de los Toldos,Única,RNac,NOA,2019m11,11,2019,NO COBRA,4,2,7,43,90,0,7,153,149
Pizarro,Única,RNac,NOA,2019m11,11,2019,NO COBRA,0,0,0,0,0,0,0,0,0
Bosques Petrificados,Única,PN,PATAGONIA,2019m11,11,2019,NO COBRA,314,135,119,10,65,25,56,724,410
Lago Puelo,Única,PN,PATAGONIA,2019m11,11,2019,COBRA,857,4617,1169,9986,1294,5283,1001,24207,23350
Laguna Blanca,Única,PN,PATAGONIA,2019m11,11,2019,NO COBRA,78,36,53,23,60,0,3,253,175
Lanín,Hua Hum,PN,PATAGONIA,2019m11,11,2019,NO COBRA,0,0,0,0,0,0,0,0,0
Lanín,Lago Huechulaufquen,PN,PATAGONIA,2019m11,11,2019,COBRA,278,1655,567,542,171,1658,14,4885,4607
Lanín,Muelle Lago Lácar,PN,PATAGONIA,2019m11,11,2019,COBRA,349,1313,483,131,614,1457,276,4623,4274
Lanín,Quila Quina,PN,PATAGONIA,2019m11,11,2019,COBRA,161,1717,499,212,624,999,221,4433,4272
Lanín,Ruka Choroy,PN,PATAGONIA,2019m11,11,2019,NO COBRA,0,0,0,0,0,0,0,0,0
Lanín,Volcán Lanín,PN,PATAGONIA,2019m11,11,2019,NO COBRA,0,0,0,0,0,0,0,0,0
Lanín,Área Tromen,PN,PATAGONIA,2019m11,11,2019,NO COBRA,0,0,0,0,0,0,0,0,0
Lanín,Ñorkinko,PN,PATAGONIA,2019m11,11,2019,NO COBRA,0,0,0,0,0,0,0,0,0
Lihué Calel,Única,PN,PATAGONIA,2019m11,11,2019,NO COBRA,17,115,195,43,279,1,85,735,718
Los Alerces,Portada Centro,PN,PATAGONIA,2019m11,11,2019,COBRA,0,0,0,0,0,0,0,0,0
Los Alerces,Portada Norte,PN,PATAGONIA,2019m11,11,2019,COBRA,0,0,0,0,0,0,0,0,0
Los Alerces,Portada Sur,PN,PATAGONIA,2019m11,11,2019,COBRA,0,0,0,0,0,0,0,0,0
Los Alerces,Villa Futalaufquen,PN,PATAGONIA,2019m11,11,2019,NO COBRA,636,1906,96,28,3,99,48,2816,2180
Los Glaciares,El Chaltén,PN,PATAGONIA,2019m11,11,2019,NO COBRA,15029,4485,0,0,0,0,0,19514,4485
Los Glaciares,Puerto Bandera,PN,PATAGONIA,2019m11,11,2019,COBRA,9744,2607,27,3444,106,0,82,16010,6266
Los Glaciares,Puerto La Cruz,PN,PATAGONIA,2019m11,11,2019,NO COBRA,0,0,0,0,0,0,0,0,0
Los Glaciares,Puerto La Soledad,PN,PATAGONIA,2019m11,11,2019,COBRA,4226,0,0,0,0,0,0,4226,0
Los Glaciares,Puerto Lago Argentino,PN,PATAGONIA,2019m11,11,2019,COBRA,0,0,0,0,0,0,0,0,0
Los Glaciares,Río Mitre,PN,PATAGONIA,2019m11,11,2019,COBRA,72608,7543,2468,2466,755,8883,1089,95812,23204
Monte León,Única,PN,PATAGONIA,2019m11,11,2019,NO COBRA,402,80,78,79,113,0,122,874,472
Nahuel Huapi,Lago Mascardi,PN,PATAGONIA,2019m11,11,2019,COBRA,2455,5255,92,8233,502,157,0,16694,14239
Nahuel Huapi,Puerto Pañuelo,PN,PATAGONIA,2019m11,11,2019,COBRA,5111,13258,540,2212,2755,5982,881,30739,25628
Nahuel Huapi,Quetrihué,PN,PATAGONIA,2019m11,11,2019,COBRA,1694,2206,573,329,1325,552,436,7115,5421
Nahuel Huapi,Río Limay,PN,PATAGONIA,2019m11,11,2019,COBRA,0,0,0,0,5418,0,0,5418,5418
Patagonia,Única,PN,PATAGONIA,2019m11,11,2019,NO COBRA,0,0,0,0,0,0,0,0,0
Perito Moreno,Única,PN,PATAGONIA,2019m11,11,2019,NO COBRA,96,14,2,3,0,0,2,117,21
Tierra del Fuego,Ruta Nacional 3,PN,PATAGONIA,2019m11,11,2019,COBRA,32354,7385,8334,0,501,3211,6917,58702,26348
Tierra del Fuego,Tren del Fin del Mundo,PN,PATAGONIA,2019m11,11,2019,COBRA,10023,7023,221,0,417,2455,495,20634,10611
Ciervo de los Pantanos,Única,PN,CENTRO,2019m12,12,2019,NO COBRA,16,18,1129,284,0,0,527,1974,1958
El Leoncito,Única,PN,CENTRO,2019m12,12,2019,NO COBRA,258,745,566,378,0,0,0,1947,1689
El Palmar,Única,PN,CENTRO,2019m12,12,2019,COBRA,204,3518,1890,672,1930,811,649,9674,9470
Iberá,Cambyretá,PN,CENTRO,2019m12,12,2019,NO COBRA,127,350,38,150,21,1,84,771,644
Iberá,San Nicolás,PN,CENTRO,2019m12,12,2019,NO COBRA,27,68,54,64,60,2,8,283,256
Mburucuyá,Única,PN,CENTRO,2019m12,12,2019,NO COBRA,25,166,186,224,33,30,233,897,872
Pre Delta,Única,PN,CENTRO,2019m12,12,2019,NO COBRA,42,799,1820,3086,126,122,1732,7727,7685
Quebrada del Condorito,Única,PN,CENTRO,2019m12,12,2019,NO COBRA,362,641,1032,129,0,0,0,2164,1802
San Guillermo,Única,PN,CENTRO,2019m12,12,2019,NO COBRA,0,0,0,0,0,0,0,0,0
Sierra de las Quijadas,Única,PN,CENTRO,2019m12,12,2019,COBRA,119,673,44,1,92,20,87,1036,917
Talampaya,Única,PN,CENTRO,2019m12,12,2019,COBRA,779,916,18,0,71,539,150,2473,1694
Chaco,Única,PN,NEA,2019m12,12,2019,NO COBRA,26,152,446,436,120,0,86,1266,1240
Colonia Benítez,Única,RNEd,NEA,2019m12,12,2019,NO COBRA,0,28,83,0,0,0,0,111,111
El Impenetrable,Única,PN,NEA,2019m12,12,2019,NO COBRA,0,26,12,0,0,0,0,38,38
Formosa,Única,RNat,NEA,2019m12,12,2019,NO COBRA,0,0,0,0,0,0,0,0,0
Iguazú,Única,PN,NEA,2019m12,12,2019,COBRA,80232,58311,6891,1578,725,5203,15769,168709,88477
Río Pilcomayo,Estero Poi,PN,NEA,2019m12,12,2019,NO COBRA,7,8,35,108,0,1,22,181,174
Río Pilcomayo,Laguna Blanca,PN,NEA,2019m12,12,2019,NO COBRA,47,116,99,1953,0,0,330,2545,2498
Aconquija,Única,PN,NOA,2019m12,12,2019,NO COBRA,2,15,73,108,0,3,17,218,216
Baritú,Única,PN,NOA,2019m12,12,2019,NO COBRA,0,0,0,0,0,0,0,0,0
Calilegua,Única,PN,NOA,2019m12,12,2019,NO COBRA,224,336,303,776,318,0,287,2244,2020
Copo,Guayacán,PN,NOA,2019m12,12,2019,NO COBRA,0,0,0,0,0,0,0,0,0
Copo,Portada,PN,NOA,2019m12,12,2019,NO COBRA,0,0,0,0,0,0,0,0,0
El Rey,Única,PN,NOA,2019m12,12,2019,NO COBRA,0,0,0,2,0,0,0,2,2
Laguna de los Pozuelos,Única,MN,NOA,2019m12,12,2019,NO COBRA,46,43,24,17,0,0,23,153,107
Los Cardones,Recta del Tín Tín,PN,NOA,2019m12,12,2019,NO COBRA,569,5097,803,280,0,5237,79,12065,11496
Los Cardones,Valle Encantado,PN,NOA,2019m12,12,2019,NO COBRA,0,0,0,0,0,0,0,0,0
Nogalar de los Toldos,Única,RNac,NOA,2019m12,12,2019,NO COBRA,69,0,11,49,22,1,45,197,128
Pizarro,Única,RNac,NOA,2019m12,12,2019,NO COBRA,0,0,0,0,0,0,0,0,0
Bosques Petrificados,Única,PN,PATAGONIA,2019m12,12,2019,NO COBRA,226,257,29,21,0,0,74,607,381
Lago Puelo,Única,PN,PATAGONIA,2019m12,12,2019,COBRA,744,10191,4249,17082,1133,1717,2150,37266,36522
Laguna Blanca,Única,PN,PATAGONIA,2019m12,12,2019,NO COBRA,30,37,57,30,0,0,28,182,152
Lanín,Hua Hum,PN,PATAGONIA,2019m12,12,2019,NO COBRA,0,0,0,0,0,0,0,0,0
Lanín,Lago Huechulaufquen,PN,PATAGONIA,2019m12,12,2019,COBRA,521,1912,557,347,334,936,171,4778,4257
Lanín,Muelle Lago Lácar,PN,PATAGONIA,2019m12,12,2019,COBRA,476,1609,613,122,311,856,312,4299,3823
Lanín,Quila Quina,PN,PATAGONIA,2019m12,12,2019,COBRA,273,2905,811,389,434,1236,671,6719,6446
Lanín,Ruka Choroy,PN,PATAGONIA,2019m12,12,2019,NO COBRA,0,0,0,0,0,0,0,0,0
Lanín,Volcán Lanín,PN,PATAGONIA,2019m12,12,2019,NO COBRA,0,0,0,0,0,0,0,0,0
Lanín,Área Tromen,PN,PATAGONIA,2019m12,12,2019,NO COBRA,0,0,0,0,0,0,0,0,0
Lanín,Ñorkinko,PN,PATAGONIA,2019m12,12,2019,NO COBRA,0,0,0,0,0,0,0,0,0
Lihué Calel,Única,PN,PATAGONIA,2019m12,12,2019,NO COBRA,81,231,51,39,0,4,96,502,421
Los Alerces,Portada Centro,PN,PATAGONIA,2019m12,12,2019,COBRA,1422,2434,3493,19389,321,1288,665,29012,27590
Los Alerces,Portada Norte,PN,PATAGONIA,2019m12,12,2019,COBRA,566,1443,813,602,120,418,321,4283,3717
Los Alerces,Portada Sur,PN,PATAGONIA,2019m12,12,2019,COBRA,105,987,726,505,53,240,44,2660,2555
Los Alerces,Villa Futalaufquen,PN,PATAGONIA,2019m12,12,2019,NO COBRA,0,0,0,0,0,0,0,0,0
Los Glaciares,El Chaltén,PN,PATAGONIA,2019m12,12,2019,NO COBRA,13219,4016,0,0,0,0,0,17235,4016
Los Glaciares,Puerto Bandera,PN,PATAGONIA,2019m12,12,2019,COBRA,12290,2023,43,2972,310,0,208,17846,5556
Los Glaciares,Puerto La Cruz,PN,PATAGONIA,2019m12,12,2019,NO COBRA,0,0,0,0,0,0,0,0,0
Los Glaciares,Puerto La Soledad,PN,PATAGONIA,2019m12,12,2019,COBRA,2538,175,0,0,0,0,0,2713,175
Los Glaciares,Puerto Lago Argentino,PN,PATAGONIA,2019m12,12,2019,COBRA,0,0,0,0,0,0,0,0,0
Los Glaciares,Río Mitre,PN,PATAGONIA,2019m12,12,2019,COBRA,97266,9934,1764,3737,1997,4472,1540,120710,23444
Monte León,Única,PN,PATAGONIA,2019m12,12,2019,NO COBRA,498,181,174,273,66,0,181,1373,875
Nahuel Huapi,Lago Mascardi,PN,PATAGONIA,2019m12,12,2019,COBRA,4402,4403,412,16202,1620,0,1,27040,22638
Nahuel Huapi,Puerto Pañuelo,PN,PATAGONIA,2019m12,12,2019,COBRA,11082,9439,432,1779,8826,5480,1539,38577,27495
Nahuel Huapi,Quetrihué,PN,PATAGONIA,2019m12,12,2019,COBRA,2423,3418,1016,454,1127,665,648,9751,7328
Nahuel Huapi,Río Limay,PN,PATAGONIA,2019m12,12,2019,COBRA,0,0,75,0,7058,0,0,7133,7133
Patagonia,Única,PN,PATAGONIA,2019m12,12,2019,NO COBRA,0,0,0,0,0,0,0,0,0
Perito Moreno,Única,PN,PATAGONIA,2019m12,12,2019,NO COBRA,123,103,1,3,0,0,9,239,116
Tierra del Fuego,Ruta Nacional 3,PN,PATAGONIA,2019m12,12,2019,COBRA,25226,5834,6181,0,927,3924,5267,47359,22133
Tierra del Fuego,Tren del Fin del Mundo,PN,PATAGONIA,2019m12,12,2019,COBRA,18830,8521,319,0,247,2257,1168,31342,12512
